微信公众号天天中彩票	微信 公众 号 天天 中 彩票
日本毛片免费视频观看	日本 毛片 免费视频 观看
大发展有限公司官网	大 发展 有限公司 官网
久久免费热在线精品	久久 免费 热 在线 精品
微信上的天天中彩票	微信 上 的 天天 中 彩票
给主人留下些什么吧	给 主人 留下 些 什么 吧
微信里的天天中彩票	微信里 的 天天 中 彩票
天天中彩票大神推荐	天天 中 彩票 大神 推荐
彩神争霸大发快三	彩神 争霸 大发 快 三
天天中彩票中大奖	天天 中 彩票 中大奖
免费视频在线观看	免费视频 在线 观看
天天中彩票双色球	天天 中 彩票 双色球
天天中彩票不中返	天天 中 彩票 不中返
中国福利彩票天天	中国 福利彩票 天天
天天中彩票为什么	天天 中 彩票 为什么
无码不卡高清免费	无码 不卡 高清 免费
无码一区二区三区	无码 一区 二区 三区
毛片免费视频观看	毛片 免费视频 观看
最新高清无码专区	最新 高清 无码 专区
公众号天天中彩票	公众 号 天天 中 彩票
微信的天天中彩票	微信 的 天天 中 彩票
天天彩票与你同行	天天 彩票 与 你 同行
天天中彩票一等奖	天天 中 彩票 一等奖
天天中彩票中奖了	天天 中 彩票 中奖 了
无码不卡高清免费	无码 不卡 高清 免费
手机上天天中彩票	手机 上 天天 中 彩票
天天中彩票是不是	天天 中 彩票 是不是
毛片高清免费视频	毛片 高清 免费视频
天天中彩票怎么买	天天 中 彩票 怎么 买
大发快三大小单双	大发 快 三 大小 单双
彩神争霸官方下载	彩神 争霸 官方 下载
精品一区二区三区	精品 一区 二区 三区
最新高清无码专区	最新 高清 无码 专区
日本一级特黄大片	日本 一级 特黄 大片
在线观看中文字幕	在线 观看 中文字幕
大发快三开奖结果	大发 快 三 开奖 结果
天天中彩票公众号	天天 中 彩票 公众 号
中国特色社会主义	中国 特色 社会主义
全民彩票天天送钱	全民 彩票 天天 送 钱
手机版天天中彩票	手机 版 天天 中 彩票
天天中彩票不能买	天天 中 彩票 不能 买
天天中彩票怎么	天天 中 彩票 怎么
天天中彩票提现	天天 中 彩票 提现
微信天天中彩票	微信 天天 中 彩票
天天中彩票中奖	天天 中 彩票 中奖
彩神争霸邀请码	彩神 争霸 邀请 码
天天中彩票微信	天天 中 彩票 微信
天天中彩票可以	天天 中 彩票 可以
天天中彩票足球	天天 中 彩票 足球
天天中彩票追号	天天 中 彩票 追号
天天中彩票如何	天天 中 彩票 如何
天天中彩票软件	天天 中 彩票软件
天天中彩票不能	天天 中 彩票 不能
手机天天中彩票	手机 天天 中 彩票
天天中彩票中了	天天 中 彩票 中 了
腾讯天天中彩票	腾讯 天天 中 彩票
天天中彩票篮球	天天 中 彩票 篮球
天天中彩票大奖	天天 中 彩票 大奖
天天中彩票官网	天天 中 彩票 官网
天天中彩票足彩	天天 中 彩票 足彩
彩神争霸怎么样	彩神 争霸 怎么样
天天中彩票派奖	天天 中 彩票 派奖
天天爱彩票怎么	天天 爱 彩票 怎么
天天中彩票提款	天天 中 彩票 提款
彩神争霸大发快	彩神 争霸 大发 快
大发时时彩计划	大发 时时 彩 计划
高清毛片在线看	高清 毛片 在线看
天天中彩票投注	天天 中 彩票 投注
天天中彩票公司	天天 中 彩票 公司
一本道高清无码	一本 道 高清 无码
天天中彩票实名	天天 中 彩票 实名
天天中彩票怎样	天天 中 彩票 怎样
大发时时彩开奖	大发 时时 彩 开奖
久久综合久久爱	久久 综合 久久 爱
天天中彩票有人	天天 中 彩票 有人
下载安装到手机	下载安装 到 手机
天天爱彩票中奖	天天 爱 彩票 中奖
天天中彩票无法	天天 中 彩票 无法
大发时时彩怎么	大发 时时 彩 怎么
彩神争霸电脑版	彩神 争霸 电脑 版
全民彩票天天送	全民 彩票 天天 送
天天中彩票开奖	天天 中 彩票 开奖
中华人民共和国	中华人民共和国
福利彩票天天彩	福利彩票 天天 彩
天天中彩票这个	天天 中 彩票 这个
大发快三是国家	大发 快三是 国家
大发快三是不是	大发 快 三 是不是
天天中彩票网站	天天 中 彩票 网站
天天中彩票在哪	天天 中 彩票 在 哪
彩神争霸邀请码	彩神 争霸 邀请 码
天天中彩票官方	天天 中 彩票 官方
海南天天中彩票	海南 天天 中 彩票
天天爱彩票提现	天天 爱 彩票 提现
天天大奖彩票站	天天 大奖 彩票 站
天天彩票中大奖	天天 彩票 中大奖
天天中彩票人工	天天 中 彩票 人工
天天中彩票任选	天天 中 彩票 任选
天天中彩票网络	天天 中 彩票 网络
热这里只有精品	热 这里 只有 精品
高频彩大发快三	高频 彩 大发 快 三
大发快三是什么	大发 快三是 什么
天天爱彩票网站	天天 爱 彩票 网站
天天中彩票出票	天天 中 彩票 出票
大发快三走势图	大发 快 三 走势图
大发快三怎么看	大发 快 三 怎么 看
彩彩票与你同行	彩 彩票 与 你 同行
彩神争霸是不是	彩神 争霸 是不是
夫妻性生活影片	夫妻 性生活 影片
天天中彩票彩金	天天 中 彩票 彩金
天天中彩票腾讯	天天 中 彩票 腾讯
天天中彩票充值	天天 中 彩票 充值
天天中彩票是	天天 中 彩票 是
视频在线观看	视频 在线 观看
天天中彩票中	天天 中 彩票 中
一区二区三区	一区 二区 三区
的天天中彩票	的 天天 中 彩票
天天中彩票有	天天 中 彩票 有
天天中彩票的	天天 中 彩票 的
彩神争霸怎么	彩神 争霸 怎么
天天中彩票能	天天 中 彩票 能
彩神争霸大发	彩神 争霸 大发
有限公司官网	有限公司 官网
福利彩票天天	福利彩票 天天
天天爱彩票是	天天 爱 彩票 是
大发时时彩是	大发 时时 彩是
大发彩票官网	大发 彩票 官网
天天彩票中奖	天天 彩票 中奖
彩神争霸官网	彩神 争霸 官网
天天中彩票网	天天 中 彩票网
视频免费观看	视频 免费 观看
大发快三彩票	大发 快 三 彩票
天天中奖彩票	天天 中奖 彩票
这里只有精品	这里 只有 精品
福利彩票天天	福利彩票 天天
和天天中彩票	和 天天 中 彩票
一级特黄大片	一级 特黄 大片
视频在线播放	视频 在线播放
大发快三怎么	大发 快 三 怎么
天天中彩票买	天天 中 彩票 买
全民彩票天天	全民 彩票 天天
大发快三开奖	大发 快 三 开奖
天天彩票怎么	天天 彩票 怎么
大发游戏官网	大发 游戏 官网
免费视频观看	免费视频 观看
彩票大发快三	彩票 大发 快 三
北京赛车怎么	北京 赛车 怎么
在天天中彩票	在 天天 中 彩票
彩神争霸提现	彩神 争霸 提现
在线观看视频	在线 观看 视频
在天天中彩票	在 天天 中 彩票
北京赛车计划	北京 赛车 计划
电影在线观看	电影 在线 观看
最新高清无码	最新 高清 无码
大发快三和值	大发 快三和值
彩神争霸苹果	彩神 争霸 苹果
免费资料大全	免费 资料 大全
北京赛车开奖	北京 赛车 开奖
天天中彩票和	天天 中 彩票 和
下载彩神争霸	下载 彩神 争霸
无码中文字幕	无码 中文字幕
天天中彩票上	天天 中 彩票 上
在线观看免费	在线 观看 免费
开奖结果查询	开奖 结果 查询
彩神争霸平台	彩神 争霸 平台
彩神争霸代理	彩神 争霸 代理
彩神争霸可以	彩神 争霸 可以
久久国产视频	久久 国产 视频
高清免费视频	高清 免费视频
微信天天彩票	微信 天天 彩票
不卡免费播放	不卡 免费 播放
大发快三计划	大发 快 三 计划
免费观看视频	免费 观看 视频
开奖现场直播	开奖 现场直播
在线视频观看	在线视频 观看
天天中彩票不	天天 中 彩票 不
彩票平台注册	彩票 平台 注册
留下些什么吧	留下 些 什么 吧
重庆时时彩的	重庆 时时 彩 的
生命周期函数	生命 周期函数
大发快三官网	大发 快 三官 网
彩神争霸快三	彩神 争霸 快 三
大发快三豹子	大发 快 三 豹子
棋牌游戏官网	棋牌 游戏 官网
手机天天彩票	手机 天天 彩票
天天中彩票粤	天天 中 彩票 粤
彩神争霸下载	彩神 争霸 下载
彩神争霸网站	彩神 争霸 网站
天天彩票提现	天天 彩票 提现
北京赛车微信	北京 赛车 微信
中国福利彩票	中国 福利彩票
北京赛车如何	北京 赛车 如何
毛片免费观看	毛片 免费 观看
大发彩票快三	大发 彩票 快 三
天天中彩票会	天天 中 彩票 会
天天中彩票被	天天 中 彩票 被
彩神争霸充值	彩神 争霸 充值
天天送钱彩票	天天 送 钱 彩票
大发快三如何	大发 快 三 如何
北京赛车女郎	北京 赛车 女郎
北京赛车冠军	北京 赛车 冠军
天天中彩票未	天天 中 彩票 未
彩神争霸输钱	彩神 争霸 输钱
娱乐平台注册	娱乐 平台 注册
北京赛车计划	北京 赛车 计划
娱乐官方网站	娱乐 官方网站
彩神争霸官方	彩神 争霸 官方
中文字幕无码	中文字幕 无码
高清视频免费	高清 视频 免费
免费在线观看	免费 在线 观看
天天中彩票谁	天天 中 彩票 谁
久久精品国产	久久 精品 国产
娱乐平台招商	娱乐 平台 招商
彩票平台招商	彩票 平台 招商
免费人成视频	免费 人成 视频
中文字幕在线	中文字幕 在线
彩神争霸破解	彩神 争霸 破解
高清在线观看	高清 在线 观看
人片在线观看	人片 在线 观看
天天中彩票在	天天 中 彩票 在
久久综合久久	久久 综合 久久
彩网大发快三	彩网 大发 快 三
网站免费观看	网站 免费 观看
彩神争霸安卓	彩神 争霸 安卓
手机在线观看	手机 在线 观看
重庆时时彩杀	重庆 时时 彩杀
彩神争霸如何	彩神 争霸 如何
买天天中彩票	买 天天 中 彩票
亚洲男人天堂	亚洲 男人 天堂
体育彩票天天	体育彩票 天天
在线视频精品	在线视频 精品
天天彩票软件	天天 彩票软件
黄色录像影片	黄色录像 影片
娱乐彩票注册	娱乐 彩票 注册
娱乐平台主管	娱乐 平台 主管
在线精品视频	在线 精品 视频
重庆时时彩彩	重庆 时时 彩彩
北京赛车投注	北京 赛车 投注
彩票娱乐注册	彩票 娱乐 注册
娱乐平台开户	娱乐 平台 开户
天天乐购彩票	天天 乐购 彩票
彩票平台开户	彩票 平台 开户
天天中彩票	天天 中 彩票
重庆时时彩	重庆 时时 彩
天天中彩票	天天 中 彩票
重庆时时彩	重庆 时时 彩
天天爱彩票	天天 爱 彩票
大发时时彩	大发 时时 彩
天天爱彩票	天天 爱 彩票
天天买彩票	天天 买 彩票
腾讯分分彩	腾讯 分分彩
大发快三是	大发 快三是
彩神争霸是	彩神 争霸 是
天天彩票网	天天 彩票网
天天赢彩票	天天 赢 彩票
大发时时彩	大发 时时 彩
时时彩平台	时时 彩 平台
片在线观看	片 在线 观看
彩神争霸有	彩神 争霸 有
凤凰大参考	凤凰 大 参考
香港六合彩	香港 六合彩
彩神争霸能	彩神 争霸 能
天天乐彩票	天天 乐 彩票
天天买彩票	天天 买 彩票
凤凰大参考	凤凰 大 参考
是什么意思	是 什么 意思
时时彩开奖	时时 彩 开奖
期开奖结果	期 开奖 结果
彩娱乐平台	彩 娱乐 平台
菲律宾申博	菲律宾 申博
客户端下载	客户端 下载
彩神争霸的	彩神 争霸 的
彩神争霸快	彩神 争霸 快
男人的天堂	男人 的 天堂
玩大发快三	玩 大发 快 三
大发分分彩	大发 分分彩
下载安装到	下载安装 到
大发快三的	大发 快 三 的
天天彩票是	天天 彩票 是
时时彩官网	时时 彩官 网
彩彩票平台	彩 彩票 平台
热在线精品	热 在线 精品
大香蕉伊人	大 香蕉 伊人
手机版下载	手机 版 下载
玩北京赛车	玩 北京 赛车
北京赛车的	北京 赛车 的
是正规的吗	是 正规 的 吗
腾讯分分彩	腾讯 分分彩
久久久久久	久久 久久 久
大发快三有	大发 快三有
大奖彩票站	大奖 彩票 站
娱乐总代理	娱乐 总代理
北京赛车女	北京 赛车 女
北京赛车有	北京 赛车 有
不了怎么办	不了 怎么办
玩彩神争霸	玩彩神 争霸
彩娱乐彩票	彩 娱乐 彩票
手机客户端	手机 客户端
彩票天天乐	彩票 天天 乐
植物百科通	植物 百科 通
天天购彩票	天天 购 彩票
彩彩票娱乐	彩 彩票 娱乐
彩神争霸高	彩神 争霸 高
北京赛车前	北京 赛车 前
植物百科通	植物 百科 通
留下些什么	留下 些 什么
是真的假的	是 真的假 的
玩北京赛车	玩 北京 赛车
的棋牌游戏	的 棋牌 游戏
北京赛车群	北京 赛车 群
人民共和国	人民共和国
可以提现吗	可以 提现 吗
的天天彩票	的 天天 彩票
平台总代理	平台 总代理
分分彩计划	分分彩 计划
彩大发快三	彩 大发 快 三
市场部联系	市场部 联系
亚历山大发	亚历山大 发
新天天彩票	新 天天 彩票
北京赛车群	北京 赛车 群
北京赛车开	北京 赛车 开
在线大香蕉	在线 大 香蕉
香港赛马会	香港 赛马会
天天好彩票	天天 好 彩票
时时彩平台	时时 彩 平台
这里只精品	这里 只 精品
玩彩神争霸	玩彩神 争霸
手机版官网	手机 版官 网
夫妻性生活	夫妻 性生活
人人摸人人	人人 摸 人人
久久综合网	久久 综合 网
天天彩票网	天天 彩票网
微信公众号	微信 公众 号
人人爽人人	人人 爽 人人
玩大发快三	玩 大发 快 三
北京赛车能	北京 赛车 能
新能源汽车	新能源 汽车
彩票总代理	彩票 总代理
天天送彩票	天天 送 彩票
波多野结衣	波多野 结衣
平台可靠吗	平台 可靠 吗
申博太阳城	申博 太阳城
软件合法吗	软件 合法 吗
日本一本道	日本 一本 道
总代理联系	总代理 联系
天天种彩票	天天 种 彩票
时时彩计划	时时 彩 计划
是合法的吗	是 合法 的 吗
片在线播放	片 在线播放
解绑银行卡	解绑 银行卡
网址是多少	网址 是 多少
大发彩票网	大发 彩票网
人人中彩票	人人 中 彩票
热久久精品	热 久久 精品
天天中彩票	天天 中 彩票
彩神争霸	彩神 争霸
彩神争霸	彩神 争霸
北京赛车	北京 赛车
大发快三	大发 快 三
天天彩票	天天 彩票
在线观看	在线 观看
北京赛车	北京 赛车
中文字幕	中文字幕
大发快三	大发 快 三
天天彩票	天天 彩票
娱乐平台	娱乐 平台
在线视频	在线视频
免费视频	免费视频
彩票平台	彩票 平台
开奖结果	开奖 结果
免费观看	免费 观看
彩经彩票	彩经 彩票
彩票天天	彩票 天天
娱乐彩票	娱乐 彩票
在线播放	在线播放
一区二区	一区 二区
官方网站	官方网站
彩票娱乐	彩票 娱乐
大发彩票	大发 彩票
影音先锋	影音 先锋
是真的吗	是 真的 吗
棋牌游戏	棋牌 游戏
精品视频	精品 视频
有限公司	有限公司
娱乐注册	娱乐 注册
下载安装	下载安装
开户网址	开户 网址
开户链接	开户 链接
注册网址	注册 网址
开户地址	开户 地址
注册地址	注册 地址
注册链接	注册 链接
精品国产	精品 国产
视频在线	视频 在线
计划软件	计划 软件
彩票天天	彩票 天天
高清无码	高清 无码
游戏官网	游戏 官网
发布时间	发布 时间
中文字幕	中文字幕
奇米影视	奇米 影视
久久久久	久久 久久
国产精品	国产 精品
开号网址	开 号 网址
开号链接	开 号 链接
责任编辑	责任编辑
娱乐官网	娱乐 官网
神彩争霸	神彩 争霸
国产精品	国产 精品
福利彩票	福利彩票
招商主管	招商 主管
送料無料	送料 無料
开号地址	开 号 地址
视频免费	视频 免费
久久综合	久久 综合
开奖号码	开奖号码
在线精品	在线 精品
分时时彩	分 时时 彩
彩票注册	彩票 注册
平台注册	平台 注册
高清免费	高清 免费
客服电话	客服 电话
开奖记录	开奖 记录
资料大全	资料 大全
与你同行	与 你 同行
娱乐开户	娱乐 开户
彩票官网	彩票 官网
官方下载	官方 下载
心水论坛	心 水 论坛
游戏平台	游戏 平台
体育投注	体育 投注
娱乐招商	娱乐 招商
平台招商	平台 招商
免费播放	免费 播放
这里只有	这里 只有
大发官网	大发 官网
幸运飞艇	幸运 飞艇
在线影院	在线影院
无码不卡	无码 不卡
大神推荐	大神 推荐
体育彩票	体育彩票
中奖彩票	中奖 彩票
彩经彩票	彩经 彩票
久久精品	久久 精品
彩票招商	彩票 招商
正规的吗	正规 的 吗
开奖直播	开奖 直播
平台开户	平台 开户
平台直属	平台 直属
彩票开户	彩票 开户
娱乐直属	娱乐 直属
平台开号	平台 开 号
购彩平台	购彩 平台
开奖现场	开奖 现场
娱乐主管	娱乐 主管
购彩官网	购彩 官网
无码专区	无码 专区
影音先锋	影音 先锋
一级特黄	一级 特黄
什么时候	什么 时候
大小单双	大小 单双
国际娱乐	国际 娱乐
真的假的	真的假 的
平台总代	平台 总代
香港马会	香港 马会
版权所有	版权所有
平台主管	平台 主管
软件下载	软件 下载
男人天堂	男人 天堂
娱乐总代	娱乐 总代
高手论坛	高手 论坛
大发官网	大发 官网
彩票总代	彩票 总代
实名认证	实名 认证
亚洲欧美	亚洲 欧美
娱乐开号	娱乐 开 号
娱乐代理	娱乐 代理
久久国产	久久 国产
平台官网	平台 官网
午夜福利	午夜 福利
彩票直属	彩票 直属
彩票主管	彩票 主管
发布时间	发布 时间
彩票开号	彩票 开 号
当前位置	当前 位置
平台代理	平台 代理
高清视频	高清 视频
怎么领奖	怎么 领奖
手机在线	手机 在线
官网下载	官网 下载
亚洲精品	亚洲 精品
电子游戏	电子游戏
最新地址	最新 地址
五月丁香	五月 丁香
久久免费	久久 免费
快三大发	快 三 大发
时时彩后	时时 彩后
合法的吗	合法 的 吗
免费人成	免费 人成
备用网址	备用 网址
福利视频	福利 视频
五月婷婷	五月 婷婷
早餐加盟	早餐 加盟
国产自拍	国产 自拍
日韩在线	日 韩 在线
亚洲视频	亚洲 视频
一级毛片	一级 毛片
娱乐登录	娱乐 登录
免费下载	免费 下载
娱乐国际	娱乐 国际
香港马会	香港 马会
亚洲欧美	亚洲 欧美
联系我们	联系 我们
招商总代	招商 总代
官网开户	官网 开户
怎么领取	怎么 领取
电影网站	电影 网站
彩票网站	彩票 网站
人體藝術	人體 藝術
娱乐网址	娱乐 网址
在线观看	在线 观看
亚洲国产	亚洲 国产
阅读全文	阅读 全文
奇米影视	奇米 影视
视频精品	视频 精品
婷婷五月	婷婷 五月
高清毛片	高清 毛片
相关文章	相关 文章
早点加盟	早点 加盟
视频网站	视频 网站
福利彩票	福利彩票
在线看片	在线看 片
什么意思	什么 意思
大发极速	大发 极速
多野结衣	多野 结衣
联系方式	联系方式
一带一路	一带 一路
不能为空	不能 为空
彩票开奖	彩票 开奖
能提现吗	能 提现 吗
国产成人	国产 成人
客服联系	客服 联系
天天送钱	天天 送 钱
开元棋牌	开元 棋牌
彩票下载	彩票 下载
亚洲综合	亚洲 综合
文章来源	文章 来源
社会主义	社会主义
彩票软件	彩票软件
彩票网址	彩票 网址
免费网站	免费 网站
中文无码	中文 无码
一肖中特	一肖中特
更新时间	更新 时间
责任编辑	责任编辑
历山大发	历山 大发
偷拍视频	偷拍 视频
同比增长	同比 增长
在线电影	在线电影
人工计划	人工 计划
无码视频	无码 视频
奇米影视	奇米 影视
预测软件	预测 软件
是多少钱	是 多少 钱
棋牌游戏	棋牌 游戏
集团官网	集团 官网
送料無料	送料 無料
友情链接	友情链接
是真是假	是 真是假
植物百科	植物 百科
不能提现	不能 提现
代理娱乐	代理 娱乐
体育在线	体育 在线
生命周期	生命周期
手机看片	手机 看片
竞彩足球	竞彩 足球
彩票代理	彩票 代理
官网娱乐	官网 娱乐
全天计划	全天 计划
威尼斯人	威尼斯人
是否合法	是否 合法
中文字幕	中文字幕
亚洲人成	亚洲 人成
娱乐下载	娱乐 下载
开户注册	开户 注册
亚洲精品	亚洲 精品
在线计划	在线 计划
综合久久	综合 久久
娱乐赚钱	娱乐 赚钱
生命周期	生命周期
无码高清	无码 高清
平特一肖	平特 一肖
个百分点	个 百分点
在线不卡	在线 不卡
监听页面	监听 页面
精品国产	精品 国产
官方网址	官方 网址
天天好彩	天天 好彩
免费观看	免费 观看
数据显示	数据 显示
免费资料	免费 资料
久久精品	久久 精品
在線觀看	在 線觀 看
大香蕉网	大 香蕉 网
奇米影视	奇米 影视
了一等奖	了 一等奖
另一方面	另一方面
联系电话	联系电话
骗人的吗	骗人 的 吗
相关阅读	相关 阅读
国产综合	国产 综合
在线国产	在线 国产
亚洲日韩	亚洲 日 韩
偷拍自拍	偷拍 自拍
免费提现	免费 提现
视频大全	视频 大全
的邀请码	的 邀请 码
転載禁止	転 載 禁止
版权所有	版权所有
成人电影	成人 电影
投注技巧	投注 技巧
免费高清	免费 高清
投注平台	投注 平台
体育官网	体育 官网
精准计划	精准 计划
在线试听	在线 试听
与此同时	与此同时
中文日韩	中文 日 韩
影音先锋	影音 先锋
中心官网	中心 官网
欧美日韩	欧 美日韩
线上娱乐	线上 娱乐
彩票计划	彩票 计划
苹果手机	苹果 手机
专题推荐	专题 推荐
网址大全	网址 大全
手机上的	手机 上 的
天空彩票	天空 彩票
发表评论	发表 评论
微信零钱	微信 零钱
以下简称	以下 简称
老时时彩	老 时时 彩
怎么下载	怎么 下载
骗局揭秘	骗局 揭秘
大发游戏	大发 游戏
先锋影音	先锋 影音
株式会社	株式会社
国际彩票	国际 彩票
上海天天	上海 天天
手游官网	手游 官网
服务热线	服务 热线
公开视频	公开 视频
手机看片	手机 看片
棋牌官网	棋牌 官网
哪个公司	哪个 公司
亚洲国产	亚洲 国产
老时时彩	老 时时 彩
相关新闻	相关 新闻
重庆时时	重庆 时时
営業時間	営 業時間
鲁夜夜啪	鲁 夜夜 啪
大发扑克	大发 扑克
自拍视频	自拍 视频
联系客服	联系 客服
関連記事	関連 記事
中国特色	中国 特色
仕事内容	仕事 内容
网页登录	网页 登录
期开什么	期开 什么
娱乐网站	娱乐 网站
伦理电影	伦理 电影
北京时间	北京 时间
现场直播	现场直播
查看更多	查看 更 多
手机官网	手机 官网
彩票登录	彩票 登录
电话号码	电话号码
助赢软件	助赢 软件
网易彩票	网易 彩票
自拍偷拍	自拍 偷拍
是真的么	是 真的 么
青青草原	青青草原
丁香五月	丁香 五月
影音先锋	影音 先锋
综合色啪	综合 色 啪
人民日报	人民日报
大发娱乐	大发 娱乐
丁香五月	丁香 五月
图片大全	图片 大全
在哪里买	在 哪里 买
游戏下载	游戏 下载
手机下载	手机 下载
最新网址	最新 网址
高清在线	高清 在线
永久免费	永久 免费
色综合网	色 综合 网
微信提现	微信 提现
极速赛车	极速 赛车
变态另类	变态 另类
成人视频	成人 视频
日韩欧美	日 韩欧美
工作人员	工作人员
地产官网	地产 官网
娱乐登陆	娱乐 登陆
超碰在线	超碰 在线
大发彩票	大发 彩票
大香线蕉	大香线 蕉
米奇影视	米奇 影视
电子游戏	电子游戏
无码亚洲	无码 亚洲
大小规律	大小 规律
相关推荐	相关 推荐
更新时间	更新 时间
黄色录像	黄色录像
中文字幕	中文字幕
大发棋牌	大发 棋牌
红黑大战	红黑 大战
东方心经	东方 心 经
综合在线	综合 在线
全民彩票	全民 彩票
中了大奖	中 了 大奖
多久到账	多久 到 账
还是假的	还是 假 的
猜你喜欢	猜 你 喜欢
体育彩票	体育彩票
发布日期	发布 日期
免责声明	免责 声明
威尼斯人	威尼斯人
天天中奖	天天 中奖
最新评论	最新 评论
亚洲日韩	亚洲 日 韩
不卡无码	不卡 无码
欧美日韩	欧 美日韩
免费无码	免费 无码
只有精品	只有 精品
官网登录	官网 登录
博彩公司	博彩 公司
经典三级	经典 三级
微软雅黑	微软 雅黑
彩票论坛	彩票论坛
幸运飞艇	幸运 飞艇
中彩票	中 彩票
时时彩	时时 彩
京赛车	京 赛车
爱彩票	爱 彩票
分分彩	分分彩
时时彩	时时 彩
经彩票	经 彩票
五分彩	五分 彩
买彩票	买 彩票
邀请码	邀请 码
分分彩	分分彩
走势图	走势图
是什么	是 什么
一本道	一本 道
手机版	手机 版
江苏快	江苏 快
大香蕉	大 香蕉
六合彩	六合彩
双色球	双色球
总代理	总代理
合法吗	合法 吗
彩票网	彩票网
彩平台	彩 平台
怎么样	怎么样
在线看	在线看
大发快	大发 快
客户端	客户端
彩娱乐	彩 娱乐
彩彩票	彩 彩票
综合网	综合 网
北京快	北京 快
为什么	为什么
怎么玩	怎么 玩
靠谱吗	靠 谱 吗
在哪里	在 哪里
赢彩票	赢 彩票
久久爱	久久 爱
安全吗	安全 吗
提现吗	提现 吗
怎么领	怎么 领
五月天	五月天
乐彩票	乐 彩票
大发快	大发 快
可靠吗	可靠 吗
娱乐城	娱乐城
电脑版	电脑 版
是真的	是 真的
色综合	色 综合
怎么办	怎么办
第四色	第四 色
彩争霸	彩 争霸
是多少	是 多少
六合彩	六合彩
五分彩	五分 彩
老虎机	老虎机
中大奖	中大奖
公众号	公众 号
青青草	青青草
太阳城	太阳城
菲律宾	菲律宾
小游戏	小游戏
老司机	老 司机
一本道	一本 道
大香蕉	大 香蕉
正规吗	正规 吗
百家乐	百家乐
送彩金	送彩金
互联网	互联网
怎么看	怎么 看
交流群	交流 群
娱乐场	娱乐场
不中返	不中返
部联系	部 联系
购彩票	购 彩票
电影网	电影网
蜘蛛词	蜘蛛 词
可信吗	可信 吗
凤凰大	凤凰 大
网页版	网页 版
的彩票	的 彩票
综合色	综合 色
资源站	资源 站
怎么买	怎么 买
习近平	习近平
斗地主	斗地主
微信群	微信群
银行卡	银行卡
多少钱	多少 钱
三级片	三级片
俺去也	俺 去 也
级毛片	级 毛片
亿美元	亿美元
注册送	注册 送
无遮挡	无遮挡
完整版	完整版
一等奖	一等奖
人民币	人民币
微信上	微信 上
做爰片	做 爰 片
苹果版	苹果 版
大发展	大 发展
久久久	久久 久
的天堂	的 天堂
三分彩	三分 彩
俄罗斯	俄罗斯
身份证	身份证
黑平台	黑 平台
有什么	有 什么
天天乐	天天 乐
免费看	免费 看
管家婆	管家婆
破解版	破解版
播放器	播放器
二维码	二维码
彩票站	彩票 站
新闻网	新闻网
新华社	新华社
原标题	原 标题
带一路	带 一路
字符串	字符串
请输入	请 输入
空彩票	空 彩票
天天好	天天 好
线观看	线 观看
的网站	的 网站
安卓版	安卓版
关键词	关键词
白小姐	白小姐
一本道	一本 道
投稿日	投稿 日
山大发	山 大发
公司的	公司 的
计划群	计划 群
尼斯人	尼斯 人
手机上	手机 上
平方米	平方米
老司机	老 司机
青青草	青青草
自己的	自己 的
大乐透	大乐透
发表于	发表 于
人人爽	人人 爽
元棋牌	元 棋牌
进一步	进一步
老司机	老 司机
计划网	计划 网
日上午	日 上午
人人摸	人人 摸
有哪些	有 哪些
的视频	的 视频
日下午	日 下午
双色球	双色球
大发云	大发 云
江苏快	江苏 快
赛马会	赛马会
加拿大	加拿大
最新版	最新版
官方网	官方网
服务器	服务器
验证码	验证码
手机版	手机 版
现金网	现金 网
一本道	一本 道
大乐透	大乐透
久久热	久久 热
近年来	近年来
支付宝	支付宝
跑狗图	跑 狗 图
数据库	数据库
博娱乐	博 娱乐
青青青	青青 青
人人看	人人 看
分享到	分享 到
官方群	官方 群
体验金	体验 金
肖中特	肖中特
有没有	有没有
天天送	天天 送
赚钱吗	赚钱 吗
为什么	为什么
新能源	新能源
情况下	情况 下
人人操	人人 操
白小姐	白小姐
夜夜啪	夜夜 啪
世界杯	世界杯
多野结	多野结
天天啪	天天 啪
机动车	机动车
七星彩	七星 彩
分快三	分快 三
的位置	的 位置
期特码	期特码
微信里	微信里
日报道	日 报道
排行榜	排行榜
国务院	国务院
联系人	联系人
二四六	二四六
官网群	官网 群
真的吗	真的 吗
用户名	用户名
发彩票	发 彩票
新时代	新 时代
人人碰	人人 碰
七星彩	七星 彩
哪个好	哪个 好
百家乐	百家乐
委员会	委员会
久久爱	久久 爱
全过程	全过程
是不是	是不是
玄机图	玄机 图
铁算盘	铁算盘
扫一扫	扫一扫
办公室	办公室
王中王	王中王
钱怎么	钱 怎么
東京都	東 京都
乱子伦	乱子 伦
作弊器	作弊器
图片区	图片 区
太阳城	太阳城
不存在	不 存在
这里只	这里 只
性生活	性生活
动态图	动态图
勤務地	勤務地
久在线	久 在线
东京热	东京 热
娱乐网	娱乐网
打不开	打不开
黑大战	黑 大战
级毛片	级 毛片
期开奖	期 开奖
开奖吗	开奖 吗
的时候	的 时候
事实上	事实上
机器人	机器人
啪啪啪	啪啪 啪
五月天	五月天
些什么	些 什么
破解器	破解器
百科通	百科 通
黄网站	黄 网站
管家婆	管家婆
三分彩	三分 彩
亚洲色	亚洲 色
黄大仙	黄大仙
免费的	免费 的
手续费	手续费
处理中	处理 中
此同时	此 同时
初始化	初始化
百分点	百分点
式会社	式 会社
一分钟	一分钟
的问题	的 问题
共和国	共和国
有没有	有没有
北京市	北京市
热视频	热 视频
天天中	天天 中
消费者	消费者
亚洲色	亚洲 色
发展的	发展 的
真实吗	真实 吗
机官网	机官 网
老虎机	老虎机
亚洲成	亚洲 成
手机号	手机号
初始化	初始化
负责人	负责人
天堂网	天堂 网
可以买	可以 买
第一页	第一页
在人线	在 人线
天天爱	天天 爱
违法吗	违法 吗
人人澡	人人 澡
大奖吗	大奖 吗
资源网	资源网
的方法	的 方法
过程中	过程 中
一分彩	一分 彩
成年人	成年人
的网址	的 网址
俺去也	俺 去 也
加勒比	加勒比
请选择	请 选择
第一次	第一次
人民网	人民网
报道称	报道 称
天下彩	天下 彩
电视剧	电视剧
种彩票	种 彩票
青青青	青青 青
彩票吗	彩票 吗
被冻结	被 冻结
管理员	管理员
打一肖	打一肖
我们的	我们 的
赛车场	赛车场
炸金花	炸 金花
大发电	大 发电
犯法吗	犯法 吗
转载请	转载 请
不了了	不了 了
自治区	自治区
天天好	天天 好
菲律宾	菲律宾
期香港	期 香港
靠谱么	靠 谱 么
真实性	真实性
骗局吗	骗局 吗
定位胆	定位 胆
二等奖	二等奖
天天众	天天 众
出版社	出版社
万美元	万美元
共产党	共产党
多少期	多少 期
房地产	房地产
电玩城	电玩 城
特朗普	特朗普
分钟前	分钟 前
中文版	中文版
电影院	电影院
二分彩	二分 彩
能提现	能 提现
怎么算	怎么 算
加拿大	加拿大
天天啪	天天 啪
的平台	的 平台
天天射	天天 射
中特网	中特网
共中央	共 中央
副书记	副 书记
的重要	的 重要
日日啪	日日 啪
人人碰	人人 碰
久久爱	久久 爱
前年比	前年 比
靠谱不	靠 谱 不
官网吗	官网 吗
亚洲区	亚洲区
总书记	总书记
派奖中	派奖 中
中央値	中央 値
前年差	前年 差
狠狠干	狠狠 干
这样的	这样 的
的发展	的 发展
小游戲	小游戲
直营网	直营 网
年以上	年 以上
香港六	香港 六
的信息	的 信息
天天彩	天天 彩
上一篇	上 一篇
第四色	第四 色
北京快	北京 快
大香蕉	大 香蕉
投注站	投注站
注册码	注册码
色综合	色 综合
曾道人	曾道人
免费线	免费 线
久久爱	久久 爱
忘初心	忘 初心
做代理	做 代理
聊天室	聊天室
不中反	不中 反
投稿日	投稿 日
小时前	小时 前
给主人	给 主人
旗舰厅	旗舰 厅
伦理片	伦理片
养老金	养老金
所在地	所在地
工作的	工作 的
中奖了	中奖 了
正规的	正规 的
中新网	中新网
不到账	不到 账
报记者	报 记者
骗人的	骗人 的
铁血网	铁血网
哪里的	哪里 的
在那里	在 那里
福彩快	福彩 快
自产拍	自产 拍
一分彩	一分 彩
个平台	个 平台
的软件	的 软件
天天送	天天 送
万家乐	万家乐
合法么	合法 么
一级片	一级 片
彩在线	彩 在线
日消息	日 消息
狠狠爱	狠狠 爱
的数据	的 数据
实际上	实际上
码中特	码中特
俺去啦	俺 去 啦
饰官网	饰 官网
天天看	天天 看
家公司	家 公司
网彩票	网 彩票
不卡的	不卡 的
发表于	发表 于
老熟妇	老熟妇
就是说	就是说
许可证	许可证
朋友圈	朋友圈
俺也去	俺 也 去
年以来	年 以来
开什么	开 什么
遂宁市	遂宁市
一本道	一本 道
期六合	期 六合
最大的	最大 的
开奖号	开奖 号
族自治	族 自治
澳门新	澳门 新
不知道	不 知道
四不像	四不像
期必中	期必 中
期资料	期 资料
一本到	一本 到
天天爱	天天 爱
色视频	色 视频
程序集	程序 集
中文字	中 文字
意味着	意味着
色情网	色情网
北海道	北海道
党中央	党中央
本港台	本港台
的天天	的 天天
叫什么	叫 什么
彩注册	彩 注册
刷流水	刷 流水
斗地主	斗地主
盈彩票	盈 彩票
了解到	了解 到
久久热	久久 热
六和彩	六和彩
痞客邦	痞客 邦
州扑克	州 扑克
曾道人	曾道人
越来越	越来越
久久热	久久 热
能买吗	能 买 吗
据了解	据 了解
进行了	进行 了
科学院	科学院
彩票	彩票
天天	天天
天天	天天
大发	大发
在线	在线
时时	时时
大发	大发
争霸	争霸
赛车	赛车
彩神	彩神
娱乐	娱乐
视频	视频
平台	平台
免费	免费
快三	快 三
官网	官网
怎么	怎么
亚洲	亚洲
久久	久久
观看	观看
重庆	重庆
网站	网站
下载	下载
开奖	开奖
分彩	分彩
注册	注册
精品	精品
网址	网址
计划	计划
日本	日本
无码	无码
国产	国产
综合	综合
软件	软件
开户	开户
游戏	游戏
手机	手机
什么	什么
中文	中文
中国	中国
时间	时间
提现	提现
高清	高清
官方	官方
代理	代理
地址	地址
亚洲	亚洲
公司	公司
最新	最新
人人	人人
中奖	中奖
欧美	欧美
播放	播放
字幕	字幕
国产	国产
彩票	彩票
开号	开 号
结果	结果
电影	电影
国际	国际
微信	微信
北京	北京
技巧	技巧
可以	可以
微信	微信
的吗	的 吗
链接	链接
走势	走势
登录	登录
棋牌	棋牌
招商	招商
投注	投注
日本	日本
香蕉	香蕉
信息	信息
体育	体育
影院	影院
日韩	日 韩
福利	福利
论坛	论坛
欧美	欧美
名無	名 無
香港	香港
五月	五月
资料	资料
手机	手机
北京	北京
合法	合法
一区	一区
图片	图片
成人	成人
主管	主管
推荐	推荐
数据	数据
服务	服务
不卡	不卡
大奖	大奖
联系	联系
本道	本道
毛片	毛片
大全	大全
二区	二 区
是真	是 真
邀请	邀请
电话	电话
多少	多少
久久	久久
六合	六合
资源	资源
工作	工作
江苏	江苏
直播	直播
直属	直属
一个	一个
客服	客服
偷拍	偷拍
安全	安全
规律	规律
天堂	天堂
发布	发布
香港	香港
先锋	先锋
新闻	新闻
没有	没有
方法	方法
影视	影视
预测	预测
作者	作者
用户	用户
自拍	自拍
在哪	在 哪
如何	如何
我们	我们
管理	管理
腾讯	腾讯
男人	男人
国家	国家
相关	相关
内容	内容
不能	不能
破解	破解
澳门	澳门
中心	中心
三级	三级
超碰	超碰
总代	总代
正规	正规
使用	使用
商品	商品
首页	首页
文章	文章
大小	大小
伊人	伊人
评论	评论
记录	记录
玩法	玩法
一级	一级
更新	更新
影音	影音
以上	以上
号码	号码
成功	成功
表示	表示
青青	青青
产品	产品
靠谱	靠 谱
发展	发展
世界	世界
人民	人民
双色	双色
分钟	分钟
夜夜	夜夜
问题	问题
足球	足球
企业	企业
客户	客户
电脑	电脑
记者	记者
博彩	博彩
安装	安装
第一	第一
申博	申博
查询	查询
骗局	骗局
三区	三区
在线	在线
奇米	奇米
彩金	彩金
亿元	亿元
公式	公式
時間	時間
人妻	人妻
登陆	登陆
婷婷	婷婷
美女	美女
来源	来源
系统	系统
充值	充值
苹果	苹果
免费	免费
生活	生活
電影	電影
分析	分析
文件	文件
编辑	编辑
网络	网络
不了	不了
失败	失败
阅读	阅读
责任	责任
四色	四色
返回	返回
马会	马会
现场	现场
狠狠	狠狠
赚钱	赚钱
真人	真人
万元	万元
所有	所有
美国	美国
设置	设置
午夜	午夜
不是	不是
单双	单双
有限	有限
专区	专区
可靠	可靠
类型	类型
网页	网页
同时	同时
活动	活动
市场	市场
修改	修改
方式	方式
另类	另类
生肖	生肖
加盟	加盟
技术	技术
今年	今年
目前	目前
更多	更 多
社会	社会
历史	历史
和值	和 值
中国	中国
这里	这里
大片	大片
汽车	汽车
小说	小说
经济	经济
赌博	赌博
中央	中央
交流	交流
介绍	介绍
导航	导航
显示	显示
参考	参考
名称	名称
日期	日期
图库	图库
小說	小說
集团	集团
提供	提供
全国	全国
进行	进行
中特	中特
删除	删除
研究	研究
彩网	彩网
报道	报道
教育	教育
其中	其中
激情	激情
登入	登入
版本	版本
自己	自己
女人	女人
以下	以下
幸运	幸运
記事	記事
怎样	怎样
色情	色情
太阳	太阳
规则	规则
位置	位置
查看	查看
下載	下載
开始	开始
电子	电子
無料	無料
通过	通过
司机	司机
需要	需要
参数	参数
送料	送料
项目	项目
只有	只有
这个	这个
当前	当前
高潮	高潮
假的	假 的
可能	可能
现金	现金
哪里	哪里
家乐	家乐
美元	美元
分享	分享
公开	公开
处理	处理
視頻	視頻
腾讯	腾讯
就是	就是
大学	大学
一肖	一肖
要求	要求
如果	如果
价格	价格
高手	高手
来源	来源
哪个	哪个
银行	银行
是否	是否
重庆	重庆
怎么	怎么
日日	日日
小时	小时
分快	分快
分类	分类
日韩	日 韩
建设	建设
丁香	丁香
最大	最大
飞艇	飞艇
今日	今日
个人	个人
政府	政府
虎机	虎机
篮球	篮球
大神	大神
人成	人成
时候	时候
安卓	安卓
追号	追号
等奖	等 奖
支持	支持
赌场	赌场
消息	消息
啪啪	啪啪
百度	百度
彩图	彩图
申博	申博
支付	支付
特码	特码
福利	福利
的是	的 是
人工	人工
今天	今天
关注	关注
情報	情報
城市	城市
看片	看片
极速	极速
公众	公众
不中	不 中
情况	情况
发表	发表
增长	增长
网上	网上
注意	注意
因此	因此
国内	国内
计算	计算
天下	天下
专家	专家
科技	科技
周年	周年
电竞	电竞
圖片	圖片
投资	投资
凤凰	凤凰
下载	下载
心水	心 水
方面	方面
合作	合作
输入	输入
人人	人人
获取	获取
资讯	资讯
影片	影片
密码	密码
律宾	律宾
最高	最高
操作	操作
购彩	购彩
其他	其他
了解	了解
真实	真实
下午	下午
选择	选择
此外	此外
现在	现在
代表	代表
兑奖	兑奖
单位	单位
福彩	福彩
无码	无码
知道	知道
第二	第二
方案	方案
系列	系列
日本	日本
详细	详细
小姐	小姐
文化	文化
实名	实名
关于	关于
专业	专业
亚游	亚游
关系	关系
意思	意思
版权	版权
状态	状态
亚洲	亚洲
韩国	韩国
澳门	澳门
设计	设计
认为	认为
永久	永久
重要	重要
最新	最新
错误	错误
学生	学生
左右	左右
真的	真的
人员	人员
点击	点击
成人	成人
少妇	少妇
熟妇	熟妇
所以	所以
无法	无法
玄机	玄机
上海	上海
免費	免費
社区	社区
全文	全文
助手	助手
存在	存在
多久	多久
作者	作者
账号	账号
取消	取消
完整	完整
搜索	搜索
投稿	投稿
美女	美女
地区	地区
进入	进入
请求	请求
详情	详情
州市	州市
朋友	朋友
可信	可信
健康	健康
黄色	黄色
咨询	咨询
组织	组织
上的	上 的
销售	销售
全部	全部
购买	购买
动态	动态
已经	已经
快三	快 三
品牌	品牌
以来	以来
联网	联网
会员	会员
捕鱼	捕鱼
漏洞	漏洞
交通	交通
基本	基本
江苏	江苏
俺去	俺 去
时代	时代
倍投	倍 投
通知	通知
获取	获取
极速	极速
实现	实现
程序	程序
统计	统计
幸运	幸运
精品	精品
标题	标题
网易	网易
完成	完成
派奖	派奖
万円	万円
模式	模式
认证	认证
简介	简介
提示	提示
列表	列表
苹果	苹果
做爰	做 爰
中的	中 的
乐透	乐透
数字	数字
出票	出票
工程	工程
定位	定位
提款	提款
人的	人 的
做愛	做 愛
页面	页面
凤凰	凤凰
线上	线上
书记	书记
竞猜	竞猜
条件	条件
了一	了 一
体验	体验
在線	在 線
股票	股票
描述	描述
生产	生产
事件	事件
特黄	特黄
送钱	送 钱
同行	同行
说明	说明
手游	手游
开发	开发
智能	智能
下一	下 一
验证	验证
发现	发现
对象	对象
根据	根据
豹子	豹子
科学	科学
日本	日本
青草	青草
足彩	足彩
红包	红包
函数	函数
添加	添加
上海	上海
比分	比分
过程	过程
作品	作品
年来	年 来
公里	公里
与你	与 你
热线	热线
網站	網站
龙虎	龙虎
不到	不到
成为	成为
优惠	优惠
关键	关键
我的	我 的
交易	交易
作弊	作弊
京都	京都
违法	违法
开心	开心
価格	価 格
全民	全民
精准	精准
天天	天天
创新	创新
的人	的 人
贴吧	贴 吧
久草	久草
杀号	杀 号
网上	网上
部门	部门
媒体	媒体
质量	质量
自动	自动
规定	规定
大家	大家
国产	国产
标准	标准
久久	久久
年的	年 的
攻略	攻略
个月	个 月
星彩	星彩
学习	学习
的一	的 一
主要	主要
网友	网友
伦理	伦理
日报	日报
一级	一级
正版	正版
申请	申请
日电	日电
报告	报告
经验	经验
禁止	禁止
韩国	韩国
改革	改革
比赛	比赛
行业	行业
法律	法律
转载	转载
控制	控制
最近	最近
公告	公告
家婆	家婆
政策	政策
执行	执行
机构	机构
因为	因为
包括	包括
订单	订单
还是	还是
年度	年度
天天	天天
未来	未来
尼斯	尼斯
同比	同比
代码	代码
保存	保存
亚洲	亚洲
蜘蛛	蜘蛛
本文	本文
影响	影响
早餐	早餐
成年	成年
最后	最后
这样	这样
环境	环境
团队	团队
狗万	狗 万
赔率	赔率
创建	创建
阅读	阅读
提高	提高
欧洲	欧洲
声明	声明
男人	男人
赢钱	赢钱
作为	作为
故事	故事
领导	领导
会议	会议
福彩	福彩
字符	字符
利用	利用
精神	精神
身份	身份
挂牌	挂牌
电视	电视
源码	源码
新聞	新聞
参加	参加
中国	中国
欢迎	欢迎
政治	政治
功能	功能
葡京	葡京
我们	我们
亚洲	亚洲
百科	百科
稳赚	稳赚
旅游	旅游
部分	部分
好的	好 的
稳定	稳定
直接	直接
特色	特色
喜欢	喜欢
中华	中华
近日	近日
工具	工具
应用	应用
藝術	藝術
金额	金额
生成	生成
正在	正在
结束	结束
无遮	无 遮
遗漏	遗漏
标签	标签
哪些	哪些
商品	商品
先生	先生
全面	全面
新华	新华
一次	一次
医院	医院
那么	那么
主题	主题
领取	领取
奖金	奖金
電話	電話
全球	全球
责编	责编
非常	非常
冻结	冻结
有效	有效
平均	平均
输钱	输钱
设备	设备
希望	希望
体彩	体彩
一本	一本
属于	属于
能力	能力
熟女	熟女
乐彩	乐彩
第三	第三
截至	截至
举报	举报
另外	另外
编号	编号
如何	如何
跑狗	跑 狗
但是	但是
任何	任何
备用	备用
詳細	詳細
信誉	信誉
广告	广告
金融	金融
产业	产业
午夜	午夜
場合	場合
其中	其中
制度	制度
关闭	关闭
近平	近平
女性	女性
米奇	米奇
连接	连接
经典	经典
到了	到 了
学校	学校
地主	地主
业务	业务
冠军	冠军
蛛词	蛛词
税込	税 込
经营	经营
指出	指出
任务	任务
然而	然而
输了	输 了
上午	上午
真假	真假
设置	设置
中了	中 了
目标	目标
全天	全天
更新	更新
几点	几点
时间	时间
来自	来自
投诉	投诉
留言	留言
之后	之后
点击	点击
不过	不过
招聘	招聘
综合	综合
体现	体现
去年	去年
主页	主页
快乐	快乐
很多	很多
下面	下面
亂倫	亂倫
人妻	人妻
拿大	拿 大
台湾	台湾
动漫	动漫
平方	平方
网易	网易
主义	主义
伊人	伊人
负责	负责
浏览	浏览
阳县	阳县
早点	早点
娱乐	娱乐
不可	不可
理论	理论
实施	实施
牲交	牲交
当然	当然
干部	干部
次数	次数
统一	统一
资金	资金
获得	获得
骗人	骗人
棋牌	棋牌
培训	培训
奇米	奇米
发生	发生
入口	入口
欧美	欧美
还有	还有
收藏	收藏
回复	回复
老师	老师
排行	排行
坚持	坚持
里面	里面
保护	保护
基础	基础
香港	香港
授权	授权
投稿	投稿
都是	都 是
人體	人體
超过	超过
解决	解决
运营	运营
委员	委员
能源	能源
万人	万人
开展	开展
异常	异常
女人	女人
领奖	领奖
出现	出现
必中	必中
文字	文字
数量	数量
迅雷	迅雷
意见	意见
例如	例如
地方	地方
噜噜	噜 噜
创建	创建
稳赢	稳赢
最多	最 多
消费	消费
注册	注册
继续	继续
接口	接口
出来	出来
酒店	酒店
偷偷	偷偷
超碰	超碰
関連	関連
东方	东方
范围	范围
保险	保险
调查	调查
名前	名前
内部	内部
到账	到 账
全年	全年
增加	增加
才能	才能
会社	会社
提出	提出
情色	情色
一直	一直
办公	办公
平特	平特
生命	生命
一步	一步
乱码	乱码
本站	本站
国内	国内
一路	一路
线路	线路
罗斯	罗斯
必须	必须
原因	原因
有人	有人
久久	久久
测试	测试
人人	人人
开放	开放
加强	加强
您的	您 的
金沙	金沙
竞彩	竞彩
因此	因此
中文	中文
买吗	买 吗
规划	规划
不同	不同
为空	为空
上传	上传
比如	比如
一码	一 码
此外	此外
以及	以及
自慰	自慰
一般	一般
起来	起来
加载	加载
地产	地产
欧美	欧美
发送	发送
特别	特别
出版	出版
大战	大战
人気	人 気
主任	主任
亚洲	亚洲
博彩	博彩
东方	东方
联盟	联盟
基地	基地
国产	国产
五星	五星
网投	网投
邮箱	邮箱
偷拍	偷拍
同时	同时
風吹	風吹
来说	来说
零钱	零钱
这些	这些
絲襪	絲襪
保障	保障
番号	番号
字段	字 段
格式	格式
始化	始化
材料	材料
推进	推进
同比	同比
阳市	阳市
照片	照片
加入	加入
两个	两个
用户	用户
重点	重点
行为	行为
山县	山县
宣传	宣传
访问	访问
剧情	剧情
取得	取得
医疗	医疗
普通	普通
検索	検 索
摘要	摘要
用品	用品
不会	不会
他们	他们
推广	推广
值得	值得
维护	维护
打开	打开
联系	联系
皇冠	皇冠
动车	动车
二维	二维
男女	男女
具体	具体
曜日	曜 日
确定	确定
或者	或者
知识	知识
学院	学院
选五	选五
参与	参与
领域	领域
丝袜	丝袜
选四	选四
期间	期间
党的	党 的
排列	排列
回答	回答
成立	成立
行动	行动
孩子	孩子
风险	风险
默认	默认
返回	返回
返点	返点
专题	专题
恐縮	恐縮
浏览	浏览
天天	天天
微博	微博
天津	天津
日至	日至
食品	食品
思想	思想
机关	机关
传奇	传奇
大厅	大厅
妹妹	妹妹
中过	中过
金沙	金沙
自治	自治
审核	审核
勤務	勤務
如果	如果
月份	月份
原创	原创
地图	地图
热门	热门
那个	那个
百度	百度
目录	目录
评论	评论
广东	广东
升级	升级
年前	年前
结构	结构
算法	算法
游戲	游戲
有关	有关
实际	实际
作用	作用
一定	一定
挂机	挂机
艺术	艺术
长龙	长龙
夫妻	夫妻
不给	不 给
联合	联合
主演	主演
期开	期开
附件	附件
帮助	帮助
落实	落实
一起	一起
中王	中王
觀看	觀看
四六	四六
性交	性交
辅助	辅助
扑克	扑克
家庭	家庭
立即	立即
如此	如此
上一	上 一
绑定	绑定
按照	按照
十二	十二
频道	频道
骗子	骗子
狠狠	狠狠
建立	建立
配置	配置
央视	央视
流水	流水
收入	收入
深圳	深圳
発送	発 送
之间	之间
数组	数组
达到	达到
世纪	世纪
下午	下午
空间	空间
推动	推动
建议	建议
属性	属性
点评	点评
办法	办法
現在	現在
免费	免费
今回	今回
十一	十一
机器	机器
彩神	彩神
服務	服務
谢谢	谢谢
周期	周期
成本	成本
马报	马报
鸿运	鸿运
看到	看到
蛋蛋	蛋蛋
哈哈	哈哈
战略	战略
至尊	至尊
一下	一下
日本	日本
下降	下降
心得	心得
晚上	晚上
不要	不要
讨论	讨论
一天	一天
持续	持续
一级	一级
丰满	丰满
制造	制造
所在	所在
停售	停售
评价	评价
基金	基金
区域	区域
角色	角色
黑人	黑人
事实	事实
看的	看 的
情侣	情侣
广东	广东
提升	提升
日日	日日
大的	大 的
本网	本网
前年	前年
分钱	分钱
调整	调整
拉菲	拉菲
百万	百万
是假	是 假
皇冠	皇冠
截图	截图
具有	具有
十分	十分
海南	海南
需求	需求
台湾	台湾
核心	核心
少妇	少妇
监听	监听
措施	措施
对于	对于
速度	速度
漫画	漫画
正式	正式
里的	里 的
如意	如意
姓名	姓名
官方	官方
秒速	秒速
移动	移动
城县	城县
精彩	精彩
目前	目前
检查	检查
説明	説 明
九九	九九
电玩	电玩
但是	但是
時計	時計
大仙	大仙
兑换	兑换
口诀	口诀
老板	老板
怎样	怎样
最快	最快
账户	账户
方向	方向
运行	运行
目的	目的
購入	購入
传真	传真
来的	来 的
水平	水平
植物	植物
激情	激情
选号	选 号
聊天	聊天
画像	画像
行政	行政
重新	重新
教学	教学
每日	每日
性愛	性愛
注销	注销
亞洲	亞洲
全集	全集
群众	群众
哥哥	哥哥
积极	积极
赢家	赢家
所以	所以
友情	友情
山市	山市
男女	男女
东京	东京
刺激	刺激
第四	第四
删除	删除
经理	经理
日前	日前
可以	可以
职业	职业
体系	体系
名字	名字
分别	分别
答案	答案
黄金	黄金
退出	退出
高清	高清
人才	人才
形成	形成
歐美	歐美
随机	随机
华人	华人
指定	指定
下注	下注
道人	道人
预计	预计
判断	判断
面积	面积
安县	安县
多野	多野
那里	那里
算盘	算盘
超碰	超碰
免費	免費
正确	正确
这一	这一
一样	一样
主席	主席
外围	外围
北京	北京
音乐	音乐
推薦	推薦
期間	期間
英国	英国
営業	営 業
新浪	新浪
简单	简单
国语	国语
和彩	和 彩
百分	百分
生态	生态
极品	极品
如果	如果
过去	过去
证券	证券
写真	写真
监督	监督
対応	対 応
喷水	喷水
视频	视频
路径	路径
课程	课程
快播	快播
金花	金花
运动	运动
天马	天马
输出	输出
最佳	最佳
图区	图区
青年	青年
新增	新增
日期	日期
成年	成年
严重	严重
颜色	颜色
接受	接受
商业	商业
宁市	宁市
十八	十八
星期	星期
玩家	玩家
也是	也 是
中国	中国
盛大	盛大
真人	真人
編集	編集
今年	今年
语言	语言
上市	上市
仕事	仕事
之前	之前
规模	规模
数据	数据
紹介	紹介
東京	東京
論壇	論壇
新的	新 的
方便	方便
浙江	浙江
允许	允许
評価	評 価
注明	注明
人体	人体
找到	找到
教师	教师
経験	経 験
琪琪	琪琪
目前	目前
制作	制作
发行	发行
现代	现代
結果	結果
每天	每天
自拍	自拍
这种	这种
是否	是否
随着	随着
共同	共同
助赢	助赢
一覧	一 覧
展示	展示
是谁	是 谁
日起	日起
养老	养老
民族	民族
看看	看看
丁香	丁香
不得	不得
少女	少女
事业	事业
汇丰	汇丰
六月	六月
价值	价值
观点	观点
暂停	暂停
人士	人士
明星	明星
盈利	盈利
天下	天下
规范	规范
自产	自 产
机制	机制
裸体	裸体
教程	教程
变态	变态
定义	定义
不开	不 开
公共	公共
形式	形式
山东	山东
实体	实体
直营	直营
予約	予約
国务	国务
考试	考试
全球	全球
卫生	卫生
販売	販 売
新宝	新宝
使用	使用
了吗	了 吗
及时	及时
人数	人数
提交	提交
我国	我国
简称	简称
节目	节目
指导	指导
返信	返信
公司	公司
贸易	贸易
乱子	乱子
网络	网络
超级	超级
环球	环球
更多	更 多
建筑	建筑
可以	可以
快速	快速
正常	正常
报警	报警
常委	常委
手续	手续
工业	工业
玩吗	玩 吗
家的	家 的
程度	程度
万辆	万辆
无限	无限
股份	股份
什么	什么
首先	首先
告诉	告诉
排名	排名
死亡	死亡
节点	节点
好友	好友
供应	供应
七星	七星
一期	一期
修改	修改
婷婷	婷婷
最终	最终
大陆	大陆
检测	检测
一些	一些
财经	财经
人氣	人氣
不断	不断
明确	明确
確認	確認
広告	広 告
但是	但是
久草	久草
对此	对此
其中	其中
胆拖	胆 拖
留下	留下
解析	解析
举行	举行
决定	决定
犯法	犯法
欧洲	欧洲
经过	经过
努力	努力
重大	重大
发布	发布
推荐	推荐
特马	特马
好运	好运
另一	另 一
動漫	動漫
自然	自然
确认	确认
报码	报码
理念	理念
导演	导演
之家	之 家
体育	体育
进口	进口
使命	使命
我要	我要
年龄	年龄
旅行	旅行
其实	其实
足球	足球
住所	住所
大唐	大唐
日時	日時
博金	博金
產品	產品
财富	财富
因此	因此
的小	的 小
比较	比较
首页	首页
六合	六合
地址	地址
优势	优势
網址	網址
比例	比例
年代	年代
农村	农村
强调	强调
打印	打印
配送	配送
图片	图片
平成	平成
保持	保持
编码	编码
一扫	一扫
深圳	深圳
河北	河北
倫理	倫理
好爽	好爽
大香	大香
実況	実 況
绿色	绿色
字号	字号
資料	資料
十三	十三
同志	同志
概率	概率
名前	名前
应该	应该
十五	十五
然后	然后
旗舰	旗舰
首页	首页
季度	季度
年第	年 第
就业	就业
采购	采购
不错	不错
地点	地点
动力	动力
犯罪	犯罪
之一	之一
登録	登 録
保证	保证
大会	大会
任选	任选
效果	效果
元素	元素
制服	制服
得到	得到
奇米	奇米
大利	大利
包括	包括
展开	展开
大圣	大圣
长期	长期
解释	解释
编辑	编辑
造成	造成
解绑	解绑
平刷	平刷
党委	党委
曝光	曝光
昨日	昨日
你的	你 的
同时	同时
唯一	唯一
転載	転 載
虽然	虽然
甚至	甚至
电话	电话
积分	积分
人大	人大
优博	优博
回血	回血
公安	公安
万能	万能
促进	促进
银河	银河
黑彩	黑彩
医生	医生
流程	流程
几个	几个
永利	永利
是一	是 一
英雄	英雄
共和	共和
合彩	合彩
澳洲	澳洲
評論	評論
一道	一道
另类	另类
复制	复制
记者	记者
导师	导师
色情	色情
大胆	大胆
车辆	车辆
协议	协议
准备	准备
新闻	新闻
海外	海外
然而	然而
原则	原则
排序	排序
黃色	黃 色
千禧	千禧
江县	江县
少婦	少婦
色色	色色
财富	财富
河北	河北
湖南	湖南
知乎	知乎
深入	深入
文件	文件
创业	创业
查询	查询
限定	限定
休日	休日
启动	启动
完善	完善
指数	指数
祥云	祥云
最好	最好
必要	必要
揭秘	揭秘
通販	通販
能够	能够
牛牛	牛牛
主人	主人
当天	当天
限制	限制
自由	自由
查看	查看
依法	依法
宁县	宁县
半年	半年
来了	来 了
開催	開 催
四川	四川
求人	求人
费用	费用
减少	减少
案例	案例
广西	广西
意味	意味
心经	心 经
黑钱	黑钱
高度	高度
调用	调用
妈妈	妈妈
财政	财政
力量	力量
儿童	儿童
勒比	勒 比
时报	时报
相關	相關
生日	生日
后的	后 的
発売	発 売
提醒	提醒
不上	不上
日志	日志
今晚	今晚
网站	网站
名人	名人
退休	退休
美国	美国
秘籍	秘籍
许可	许可
真钱	真钱
按钮	按钮
伯爵	伯爵
公交	公交
环球	环球
完全	完全
人物	人物
你懂	你 懂
传统	传统
日晚	日晚
一本	一本
停止	停止
资本	资本
吉林	吉林
来看	来看
未知	未知
性感	性感
在人	在 人
宝宝	宝宝
吉祥	吉祥
一号	一号
所以	所以
乐盈	乐盈
利益	利益
以上	以上
预算	预算
否则	否则
污染	污染
拥有	拥有
都会	都 会
多宝	多宝
输入	输入
的话	的话
针对	针对
做好	做好
疫情	疫情
我和	我 和
如今	如今
权限	权限
初心	初 心
久热	久 热
随后	随后
玖玖	玖 玖
以内	以内
出租	出租
成果	成果
这么	这么
军事	军事
刷新	刷新
总部	总部
集中	集中
电竞	电竞
亚洲	亚洲
蒙古	蒙古
了承	了 承
又爽	又 爽
來源	來源
设施	设施
非法	非法
文明	文明
天天	天天
龙江	龙江
违规	违规
广州	广州
港台	港台
免费	免费
動画	動画
银河	银河
推出	推出
治理	治理
日博	日博
安市	安市
收费	收费
监管	监管
多个	多个
因为	因为
如下	如下
试看	试看
意识	意识
南京	南京
购物	购物
实力	实力
電子	電子
以下	以下
祥云	祥云
通常	通常
狐狸	狐狸
理由	理由
博悦	博悦
连续	连续
時計	時計
下一	下 一
商品	商品
会上	会上
成员	成员
吉利	吉利
卓越	卓越
以前	以前
产品	产品
歓迎	歓 迎
首页	首页
共享	共享
备注	备注
信用	信用
导致	导致
诺亚	诺亚
无线	无线
麒麟	麒麟
中新	中 新
爽爽	爽爽
女性	女性
侵犯	侵犯
女孩	女孩
最长	最长
的大	的 大
没有	没有
阶段	阶段
到底	到底
背景	背景
农业	农业
当地	当地
了承	了 承
达人	达 人
星际	星际
利润	利润
姐姐	姐姐
又黄	又 黄
欢乐	欢乐
这是	这是
強奸	強奸
万国	万国
身体	身体
停车	停车
快播	快播
打造	打造
合同	合同
博客	博客
截至	截至
万博	万博
共产	共产
复式	复式
都市	都市
追加	追加
报价	报价
时时	时时
另外	另外
趋势	趋势
添加	添加
结合	结合
大阪	大阪
物流	物流
徒歩	徒歩
公布	公布
死人	死人
通过	通过
长度	长度
菲娱	菲娱
礼包	礼包
姑娘	姑娘
输出	输出
料金	料金
天津	天津
倍率	倍率
掲載	掲 載
容易	容易
胆码	胆码
亚游	亚游
人与	人 与
屁股	屁股
精选	精选
指南	指南
宝典	宝典
其它	其它
三級	三級
治疗	治疗
今回	今回
职位	职位
一句	一句
印度	印度
受到	受到
人口	人口
实践	实践
年轻	年轻
诚信	诚信
日本	日本
河内	河内
露脸	露脸
漂亮	漂亮
不限	不 限
环保	环保
竞争	竞争
和尚	和尚
科研	科研
居民	居民
跨度	跨度
十九	十九
男性	男性
华夏	华夏
自在	自 在
湖北	湖北
招生	招生
不过	不过
变化	变化
天地	天地
日讯	日讯
被骗	被 骗
安排	安排
方法	方法
几年	几年
类别	类别
提前	提前
巡视	巡视
各种	各种
万吨	万吨
省委	省委
河南	河南
人生	人生
评分	评分
企業	企業
千万	千万
案件	案件
隐藏	隐藏
万盛	万盛
亞洲	亞洲
合买	合买
水果	水果
江西	江西
传播	传播
他们	他们
秒速	秒速
彩票	彩票
伙伴	伙伴
开的	开 的
共有	共有
金盾	金盾
滚球	滚球
无限	无限
签到	签到
余额	余额
指标	指标
夜夜	夜夜
挣钱	挣钱
高校	高校
交换	交换
纪律	纪律
主持	主持
江西	江西
护士	护士
年底	年底
彩乐	彩乐
給与	給与
永利	永利
法院	法院
资产	资产
欧亿	欧亿
之外	之外
国际	国际
通信	通信
悠悠	悠悠
研发	研发
环亚	环亚
参数	参数
财神	财神
党员	党员
那些	那些
章节	章节
报名	报名
条例	条例
不好	不好
营业	营业
姐妹	姐妹
裸體	裸體
毕业	毕业
外挂	外挂
类似	类似
岗位	岗位
商务	商务
情色	情色
閱讀	閱讀
类型	类型
觉得	觉得
南县	南县
兼职	兼职
山东	山东
定胆	定胆
文学	文学
合乐	合乐
導航	導航
意义	意义
引用	引用
办理	办理
这是	这是
制服	制服
久久	久久
刷水	刷水
在线	在线
合理	合理
高频	高频
后二	后 二
赌球	赌球
试听	试听
交換	交換
举办	举办
外交	外交
施工	施工
加坡	加坡
一点	一点
下来	下来
丁目	丁目
无极	无极
税込	税 込
纪委	纪委
海道	海道
素材	素材
文本	文本
我要	我要
关于	关于
后台	后台
大丰	大丰
哪里	哪里
经历	经历
准确	准确
热点	热点
东森	东森
而言	而言
我的	我 的
动画	动画
禁止	禁止
飞机	飞机
摩臣	摩臣
那么	那么
柴油	柴油
皇家	皇家
游戏	游戏
盘口	盘口
此前	此前
按摩	按摩
事故	事故
新人	新人
平码	平码
有码	有 码
更加	更加
为了	为了
法人	法人
市委	市委
截止	截止
组合	组合
便利	便利
媽媽	媽媽
相談	相談
云鼎	云鼎
航空	航空
战争	战争
金币	金币
白浆	白浆
很好	很 好
工资	工资
严格	严格
安卓	安卓
小米	小米
最低	最低
服务	服务
安迪	安迪
全天	全天
幸福	幸福
英文	英文
救世	救世
过滤	过滤
确保	确保
本人	本人
美国	美国
私人	私人
发挥	发挥
贯彻	贯彻
菠菜	菠菜
包含	包含
安徽	安徽
除了	除了
概要	概要
大师	大师
左旗	左旗
期期	期期
重量	重量
模拟	模拟
填写	填写
迅雷	迅雷
地域	地域
实时	实时
全民	全民
马上	马上
利来	利来
感谢	感谢
注文	注文
登录	登录
朗普	朗普
易购	易购
性爱	性爱
优化	优化
看来	看来
新疆	新疆
哈尔	哈尔
担当	担当
打法	打法
冠亚	冠亚
比如	比如
丰富	丰富
增强	增强
后三	后 三
动物	动物
多人	多人
邮件	邮件
根据	根据
学历	学历
五码	五码
分类	分类
高速	高速
快乐	快乐
百汇	百汇
誘惑	誘惑
诈骗	诈骗
智慧	智慧
期限	期限
名单	名单
部署	部署
实现	实现
內容	內容
彩堂	彩堂
保存	保存
今年	今年
百乐	百乐
高登	高登
中国	中国
新版	新版
总站	总站
特点	特点
成绩	成绩
期待	期待
观察	观察
青春	青春
竞技	竞技
捕鱼	捕鱼
日本	日本
特殊	特殊
一年	一年
黄色	黄色
乐城	乐城
杭州	杭州
同创	同创
世爵	世爵
面的	面 的
涉及	涉及
税込	税 込
银航	银航
而且	而且
武汉	武汉
德国	德国
请求	请求
昨天	昨天
水县	水县
回复	回复
等级	等级
博猫	博猫
动作	动作
录像	录像
杀码	杀码
大众	大众
超碰	超碰
天堂	天堂
出了	出 了
工作	工作
爆乳	爆乳
宝盈	宝盈
小说	小说
活動	活動
私彩	私彩
伟德	伟德
編集	編集
出口	出口
软件	软件
河县	河县
资格	资格
体彩	体彩
东西	东西
现实	现实
坚持	坚持
延期	延期
充分	充分
做到	做到
施設	施設
葡京	葡京
亿贝	亿贝
采取	采取
试玩	试玩
教授	教授
开彩	开彩
順位	順位
对应	对应
中国	中国
吃奶	吃奶
还能	还 能
英语	英语
认真	认真
贵州	贵州
的钱	的 钱
社員	社員
月底	月底
川县	川县
浙江	浙江
爱情	爱情
医学	医学
示例	示例
效率	效率
缩水	缩水
秘诀	秘诀
設定	設定
冷热	冷热
用于	用于
成都	成都
论文	论文
采访	采访
奖励	奖励
住宅	住宅
创造	创造
点赞	点赞
破解	破解
仲博	仲博
人在	人 在
世博	世博
双方	双方
兑现	兑现
匿名	匿名
幻想	幻想
病毒	病毒
碰碰	碰碰
出的	出 的
近期	近期
心博	心博
丰满	丰满
平县	平县
扒开	扒开
天音	天音
最近	最近
医保	医保
赛车	赛车
财神	财神
場所	場所
机械	机械
短信	短信
传媒	传媒
出生	出生
谁有	谁 有
教材	教材
奥门	奥门
未经	未经
如果	如果
银座	银座
距离	距离
代引	代引
乐购	乐购
部长	部长
运输	运输
心理	心理
员工	员工
已有	已有
注意	注意
乐天	乐天
贷款	贷款
西亚	西亚
产生	产生
深爱	深爱
突破	突破
明显	明显
即可	即可
召开	召开
巨大	巨大
最後	最 後
机会	机会
付款	付款
新品	新品
大量	大量
套餐	套餐
覆盖	覆盖
菠菜	菠菜
伯温	伯温
等待	等待
福建	福建
警方	警方
其次	其次
信息	信息
强化	强化
性色	性色
公開	公開
真正	真正
欧美	欧美
为何	为何
评级	评级
解除	解除
韓國	韓國
不用	不用
同步	同步
羽林	羽林
降低	降低
大洋	大洋
公益	公益
仕様	仕 様
广发	广发
問題	問題
必赢	必赢
开启	开启
楽天	楽 天
董事	董事
拍拍	拍拍
晒单	晒单
玩的	玩 的
退款	退款
事情	事情
我們	我們
通讯	通讯
包装	包装
去了	去 了
大连	大连
井空	井空
春节	春节
割合	割合
尺寸	尺寸
和记	和 记
合集	合集
制定	制定
国外	国外
江市	江市
提高	提高
东京	东京
和盛	和 盛
少年	少年
加工	加工
主页	主页
党建	党建
出处	出处
六肖	六肖
公爵	公爵
商城	商城
料理	料理
金尊	金尊
同期	同期
帝一	帝一
后一	后 一
疯狂	疯狂
回应	回应
龙虎	龙虎
速報	速報
分類	分類
博乐	博乐
组六	组六
三国	三国
博士	博士
经纬	经纬
复杂	复杂
中天	中 天
辽宁	辽宁
資訊	資訊
年份	年份
讯网	讯 网
女子	女子
日产	日产
淘宝	淘宝
是在	是 在
首次	首次
高中	高中
转换	转换
劳动	劳动
天空	天空
路线	路线
博众	博众
宣布	宣布
组三	组三
介紹	介紹
第一	第一
主营	主营
是不	是 不
窗口	窗口
応募	応 募
组选	组选
希望	希望
宝马	宝马
杏彩	杏彩
以后	以后
河南	河南
融资	融资
終了	終了
满足	满足
海南	海南
旗下	旗下
金砖	金砖
赛事	赛事
帝苑	帝苑
技能	技能
患者	患者
将在	将 在
好运	好运
老妇	老妇
大型	大型
都有	都 有
受付	受付
压力	压力
固定	固定
透明	透明
套路	套路
女生	女生
菜单	菜单
播播	播播
待遇	待遇
优秀	优秀
法规	法规
住房	住房
采用	采用
累计	累计
测速	测速
中古	中古
校园	校园
聯系	聯系
久赢	久 赢
天气	天气
手機	手機
自动	自动
至尚	至尚
承担	承担
岁的	岁 的
开心	开心
猜你	猜 你
职责	职责
就是	就是
读取	读取
尚度	尚度
是哪	是 哪
暂无	暂无
尼姑	尼姑
久游	久游
藏宝	藏宝
乐友	乐友
公斤	公斤
球队	球队
以及	以及
俺也	俺 也
反水	反水
环宇	环宇
线程	线程
鸿丰	鸿丰
钱柜	钱柜
泰皇	泰皇
八码	八码
缴情	缴情
巴黎	巴黎
高级	高级
符合	符合
女士	女士
扫描	扫描
上午	上午
协会	协会
偷窥	偷窥
家具	家具
法国	法国
由于	由于
城区	城区
时期	时期
王者	王者
不像	不像
相比	相比
娛樂	娛樂
反馈	反馈
诀窍	诀窍
对白	对白
内容	内容
南京	南京
国产	国产
的新	的 新
此次	此次
土地	土地
今日	今日
博牛	博牛
紫金	紫金
所得	所得
自身	自身
门户	门户
销量	销量
帐号	帐号
上映	上映
整体	整体
三星	三星
工商	工商
独胆	独胆
理解	理解
感觉	感觉
贝博	贝博
易乐	易乐
九龙	九龙
好吗	好 吗
場合	場合
国家	国家
奔驰	奔驰
資格	資格
大道	大道
红鹰	红鹰
栏目	栏目
実況	実 況
開始	開始
马会	马会
明发	明发
微软	微软
麻豆	麻豆
附近	附近
天逸	天逸
重复	重复
监察	监察
模块	模块
玩家	玩家
第二	第二
正点	正点
高升	高升
圣亚	圣亚
弘鼎	弘鼎
坑人	坑人
記事	記事
熱門	熱門
当前	当前
扩大	扩大
直到	直到
龙头	龙头
在线	在线
无需	无需
中国	中国
必胜	必胜
满意	满意
假吗	假 吗
荣富	荣富
人格	人格
面对	面对
主播	主播
做人	做人
今天	今天
别人	别人
博凯	博凯
个位	个 位
他说	他 说
规格	规格
突然	突然
只能	只能
成熟	成熟
长沙	长沙
奶头	奶头
牢记	牢记
终于	终于
新区	新区
伊人	伊人
尔沁	尔沁
名稱	名稱
上述	上述
整数	整数
利来	利来
诺果	诺果
搜尋	搜尋
尺度	尺度
一致	一致
返水	返水
视觉	视觉
数学	数学
默认	默认
収納	収 納
依据	依据
然后	然后
纽约	纽约
改善	改善
违反	违反
學生	學生
变量	变量
组成	组成
安心	安心
銀行	銀行
革命	革命
黄片	黄片
神器	神器
予定	予定
分享	分享
有所	有所
種類	種類
字体	字体
厨房	厨房
状態	状態
额度	额度
事项	事项
预约	预约
所属	所属
没人	没 人
无人	无人
后来	后来
老師	老師
昌县	昌县
于是	于是
亚豪	亚豪
铁血	铁血
我是	我 是
金叶	金叶
买马	买 马
右翼	右翼
城乡	城乡
白菜	白菜
陕西	陕西
上下	上下
乐彩	乐彩
只是	只是
聚缘	聚缘
批准	批准
车型	车型
日在	日 在
店舗	店 舗
云南	云南
讲话	讲话
岛国	岛国
主动	主动
老太	老太
中旗	中旗
也是	也 是
你好	你好
沒有	沒有
吉林	吉林
实验	实验
感染	感染
天铭	天铭
给予	给予
月至	月 至
传真	传真
男子	男子
内幕	内幕
神马	神马
最大	最大
盒彩	盒彩
赌博	赌博
対象	対 象
一诺	一诺
全国	全国
强奷	强 奷
疾病	疾病
神算	神算
尊尼	尊尼
保証	保 証
等等	等等
十大	十大
年至	年 至
纪录	纪录
行情	行情
変更	変 更
驾驶	驾驶
不足	不足
性质	性质
即时	即时
乐丰	乐丰
天游	天游
课堂	课堂
作爱	作 爱
相信	相信
老婆	老婆
豪泰	豪泰
策略	策略
挑战	挑战
前三	前 三
红鼎	红鼎
厘米	厘米
组件	组件
蓝盾	蓝盾
还有	还有
病例	病例
凌晨	凌晨
源县	源县
上涨	上涨
優惠	優惠
品質	品質
左右	左右
当然	当然
不起	不起
地下	地下
追回	追回
布局	布局
拼搏	拼搏
所谓	所谓
富利	富利
登记	登记
市場	市場
三个	三个
去哪	去 哪
他的	他 的
串一	串一
顶部	顶部
投入	投入
秘密	秘密
十四	十四
截至	截至
京都	京都
基层	基层
装修	装修
十二	十二
银雀	银雀
集合	集合
分鐘	分鐘
渠道	渠道
危险	危险
贡献	贡献
改单	改单
对于	对于
涉嫌	涉嫌
证明	证明
跑路	跑 路
印尼	印尼
霸王	霸王
备案	备案
困难	困难
整改	整改
广大	广大
久久	久久
机场	机场
恢复	恢复
整个	整个
扫码	扫码
好多	好多
皇家	皇家
发动	发动
华都	华 都
歌曲	歌曲
在线	在线
那么	那么
女优	女优
映画	映画
步骤	步骤
第五	第五
星空	星空
新浪	新浪
表现	表现
財布	財布
亿博	亿博
区别	区别
鼎丰	鼎丰
关于	关于
想到	想到
成长	成长
万个	万个
否则	否则
天然	天然
舒服	舒服
成交	成交
趣赢	趣赢
改变	改变
漫畫	漫畫
分页	分页
整理	整理
荣耀	荣耀
避免	避免
线蕉	线蕉
福建	福建
钱包	钱包
公司	公司
自行	自行
作文	作文
億元	億元
特徴	特 徴
深化	深化
进去	进去
头像	头像
总结	总结
党组	党组
午後	午 後
寻找	寻找
广益	广益
首頁	首頁
模型	模型
官网	官网
网赌	网赌
的不	的 不
途中	途中
粉嫩	粉嫩
狼人	狼人
人體	人體
川県	川 県
至尊	至尊
人为	人为
库存	库存
性感	性感
营销	营销
週間	週間
免责	免责
东臣	东臣
坚定	坚定
聚利	聚利
用了	用 了
東京	東京
尤其	尤其
厕所	厕所
子的	子 的
利盛	利盛
维修	维修
同性	同性
争锋	争锋
世界	世界
属性	属性
募集	募集
兴趣	兴趣
透露	透露
回事	回事
国产	国产
奋斗	奋斗
来到	来到
凯美	凯美
菲龙	菲龙
住宿	住宿
一卡	一卡
歌词	歌词
搜狐	搜狐
专项	专项
小学	小学
领先	领先
幕后	幕后
韦伯	韦伯
返品	返品
现在	现在
网赌	网赌
乐多	乐多
西游	西游
不少	不少
缓存	缓存
老人	老人
放心	放心
客邦	客邦
对刷	对刷
司法	司法
新疆	新疆
广西	广西
消防	消防
总统	总统
大鱼	大鱼
回来	回来
三肖	三肖
实例	实例
考虑	考虑
品质	品质
欢乐	欢乐
玖玖	玖 玖
协调	协调
宝马	宝马
九州	九州
外国	外国
美容	美容
您好	您好
客様	客 様
处罚	处罚
不停	不停
和平	和平
优宝	优宝
客邦	客邦
返钱	返钱
絲襪	絲襪
香蕉	香蕉
七彩	七彩
型号	型号
收藏	收藏
可是	可是
物业	物业
道路	道路
森林	森林
四川	四川
因素	因素
空气	空气
根据	根据
响应	响应
业内	业内
套利	套利
一家	一家
出台	出台
先进	先进
表达	表达
雪球	雪球
训练	训练
京城	京城
再次	再次
天天	天天
巴黎	巴黎
出去	出去
售价	售价
非常	非常
厂家	厂家
至少	至少
融合	融合
判断	判断
谢谢	谢谢
亂倫	亂倫
政协	政协
探索	探索
人気	人 気
公务	公务
朋克	朋克
出演	出演
乐亚	乐亚
本科	本科
例如	例如
视讯	视讯
梦想	梦想
新生	新生
今日	今日
加强	加强
事項	事項
想着	想着
培养	培养
爱的	爱 的
性能	性能
对子	对子
演员	演员
毫米	毫米
安徽	安徽
七喜	七喜
帝景	帝景
最准	最准
权益	权益
雅黑	雅黑
亚美	亚美
浩特	浩特
打一	打一
直选	直选
黄金	黄金
说道	说道
几十	几十
垃圾	垃圾
猛烈	猛烈
插件	插件
發布	發布
声音	声音
質問	質問
好了	好 了
活动	活动
律师	律师
中色	中色
标签	标签
一个	一个
早餐	早餐
买法	买法
铁路	铁路
中國	中國
正文	正文
上传	上传
溪县	溪县
星期	星期
发财	发财
东北	东北
商品	商品
循环	循环
东县	东 县
在線	在 線
广播	广播
山区	山区
偽物	偽物
魔兽	魔兽
释放	释放
给吗	给 吗
认可	认可
鱼儿	鱼儿
攻击	攻击
琪琪	琪琪
價格	價格
右旗	右旗
来越	来 越
萬元	萬元
产权	产权
七码	七码
帖子	帖子
入住	入住
伊人	伊人
游客	游客
红姐	红姐
性的	性 的
皇轩	皇轩
新乐	新乐
入力	入力
邦尼	邦尼
一个	一个
除此	除 此
専門	専 門
中字	中字
摄影	摄影
不过	不过
句话	句 话
护理	护理
快捷	快捷
六码	六码
年間	年間
教師	教師
企鹅	企鹅
昵称	昵称
收益	收益
万亚	万亚
思思	思思
比較	比較
实行	实行
环亚	环亚
湖北	湖北
爱赢	爱 赢
审批	审批
就在	就 在
用途	用途
自主	自主
树林	树林
让我	让 我
秘书	秘书
出售	出售
收到	收到
多数	多数
残局	残局
黑人	黑人
盈立	盈立
一种	一种
需要	需要
令人	令人
大金	大 金
举报	举报
模板	模板
朋克	朋克
不仅	不仅
設備	設備
爸爸	爸爸
容量	容量
万利	万 利
上线	上线
扶贫	扶贫
来也	来 也
例如	例如
拉特	拉特
页面	页面
企业	企业
護士	護士
股票	股票
突出	突出
主体	主体
多乐	多乐
丈夫	丈夫
装备	装备
全国	全国
民主	民主
众鑫	众鑫
处分	处分
满堂	满堂
总体	总体
公网	公网
美國	美國
本金	本金
安全	安全
恒一	恒一
认识	认识
動畫	動畫
力度	力度
互动	互动
尤物	尤物
关联	关联
成都	成都
三码	三码
日本	日本
事务	事务
呻吟	呻吟
會員	會員
马克	马克
爵士	爵士
麻将	麻将
公平	公平
年月	年 月
多年	多年
財布	財布
彩	彩
天	天
彩	彩
中	中
的	的
大	大
时	时
网	网
人	人
在	在
发	发
日	日
一	一
年	年
线	线
乐	乐
分	分
京	京
开	开
国	国
车	车
月	月
是	是
三	三
京	京
视	视
快	快
不	不
久	久
赛	赛
平	平
争	争
有	有
霸	霸
新	新
频	频
娱	娱
台	台
下	下
看	看
官	官
么	么
奖	奖
码	码
本	本
上	上
费	费
品	品
免	免
合	合
吗	吗
色	色
了	了
机	机
号	号
片	片
注	注
文	文
亚	亚
产	产
重	重
方	方
期	期
美	美
全	全
信	信
影	影
区	区
站	站
公	公
金	金
高	高
成	成
洲	洲
地	地
理	理
用	用
法	法
怎	怎
无	无
电	电
观	观
图	图
小	小
址	址
生	生
和	和
最	最
现	现
个	个
以	以
会	会
手	手
件	件
载	载
家	家
多	多
市	市
为	为
名	名
作	作
庆	庆
能	能
出	出
爱	爱
版	版
精	精
代	代
行	行
可	可
户	户
提	提
计	计
来	来
女	女
元	元
游	游
万	万
县	县
自	自
到	到
体	体
主	主
数	数
册	册
情	情
子	子
利	利
我	我
五	五
道	道
第	第
前	前
经	经
要	要
果	果
二	二
安	安
资	资
真	真
博	博
好	好
入	入
字	字
者	者
播	播
特	特
点	点
这	这
划	划
性	性
动	动
心	心
商	商
业	业
间	间
部	部
学	学
级	级
事	事
定	定
里	里
买	买
后	后
度	度
关	关
水	水
球	球
工	工
玩	玩
通	通
清	清
投	投
加	加
香	香
规	规
源	源
钱	钱
内	内
信	信
料	料
表	表
对	对
系	系
报	报
直	直
登	登
软	软
美	美
实	实
戏	戏
综	综
同	同
说	说
结	结
送	送
服	服
位	位
接	接
城	城
什	什
放	放
面	面
于	于
技	技
场	场
管	管
拍	拍
交	交
司	司
回	回
正	正
录	录
总	总
無	無
夜	夜
如	如
论	论
式	式
请	请
目	目
选	选
客	客
解	解
页	页
院	院
港	港
老	老
之	之
外	外
门	门
过	过
牌	牌
今	今
进	进
所	所
取	取
单	单
明	明
群	群
等	等
据	据
记	记
他	他
长	长
力	力
六	六
少	少
化	化
次	次
四	四
大	大
热	热
男	男
福	福
更	更
民	民
务	务
与	与
当	当
山	山
哪	哪
得	得
推	推
比	比
神	神
马	马
类	类
走	走
相	相
保	保
青	青
国	国
意	意
联	联
時	時
此	此
卡	卡
先	先
都	都
示	示
值	值
社	社
建	建
赢	赢
你	你
集	集
际	际
海	海
米	米
也	也
幕	幕
口	口
讯	讯
就	就
运	运
息	息
育	育
制	制
其	其
势	势
招	招
量	量
样	样
双	双
任	任
物	物
查	查
州	州
円	円
格	格
超	超
做	做
程	程
西	西
设	设
何	何
去	去
器	器
专	专
话	话
们	们
题	题
展	展
布	布
星	星
原	原
韩	韩
购	购
無	無
知	知
新	新
速	速
亿	亿
十	十
东	东
员	员
路	路
律	律
宝	宝
黄	黄
科	科
链	链
南	南
没	没
活	活
被	被
百	百
阳	阳
巧	巧
型	型
将	将
教	教
偷	偷
音	音
牌	牌
使	使
属	属
近	近
限	限
改	改
领	领
江	江
首	首
而	而
流	流
政	政
标	标
评	评
起	起
打	打
参	参
章	章
蕉	蕉
导	导
至	至
世	世
局	局
王	王
预	预
容	容
然	然
测	测
彩	彩
返	返
空	空
堂	堂
草	草
毛	毛
龙	龙
一	一
求	求
置	置
未	未
思	思
红	红
足	足
碰	碰
苏	苏
黑	黑
靠	靠
肖	肖
还	还
组	组
算	算
编	编
证	证
问	问
共	共
华	华
统	统
传	传
間	間
赌	赌
金	金
婷	婷
价	价
装	装
感	感
店	店
立	立
奇	奇
分	分
着	着
友	友
坛	坛
输	输
周	周
午	午
易	易
持	持
啪	啪
手	手
称	称
从	从
常	常
众	众
白	白
言	言
优	优
告	告
香	香
九	九
强	强
電	電
考	考
想	想
荐	荐
包	包
吧	吧
认	认
骗	骗
及	及
基	基
破	破
假	假
斯	斯
太	太
完	完
因	因
介	介
狠	狠
云	云
消	消
创	创
妻	妻
头	头
除	除
已	已
身	身
只	只
例	例
克	克
很	很
干	干
讯	讯
那	那
应	应
功	功
收	收
支	支
权	权
责	责
北	北
列	列
界	界
读	读
江	江
妇	妇
但	但
助	助
战	战
案	案
态	态
处	处
指	指
办	办
率	率
受	受
存	存
天	天
申	申
票	票
闻	闻
伊	伊
在	在
房	房
条	条
连	连
两	两
种	种
转	转
书	书
锋	锋
付	付
光	光
增	增
款	款
询	询
师	师
花	花
修	修
备	备
团	团
邀	邀
省	省
整	整
准	准
广	广
始	始
必	必
股	股
供	供
调	调
并	并
赚	赚
给	给
企	企
风	风
党	党
些	些
木	木
火	火
操	操
则	则
向	向
博	博
竞	竞
充	充
尔	尔
士	士
委	委
虎	虎
航	航
失	失
军	军
试	试
术	术
历	历
河	河
第	第
环	环
营	营
项	项
验	验
名	名
极	极
画	画
治	治
复	复
几	几
达	达
德	德
由	由
别	别
库	库
医	医
另	另
林	林
激	激
财	财
模	模
具	具
土	土
記	記
反	反
节	节
深	深
牛	牛
乐	乐
排	排
需	需
又	又
網	網
八	八
配	配
倍	倍
姐	姐
早	早
或	或
追	追
密	密
業	業
愛	愛
皇	皇
場	場
圖	圖
端	端
非	非
陆	陆
造	造
動	動
每	每
研	研
果	果
演	演
英	英
带	带
杀	杀
引	引
丰	丰
飞	飞
盘	盘
网	网
售	售
击	击
语	语
步	步
盛	盛
室	室
報	報
质	质
稳	稳
人	人
盟	盟
川	川
爽	爽
笑	笑
形	形
校	校
照	照
钟	钟
队	队
史	史
中	中
确	确
住	住
拉	拉
万	万
富	富
伦	伦
乱	乱
施	施
各	各
気	気
色	色
效	效
变	变
旗	旗
私	私
气	气
宁	宁
食	食
脑	脑
快	快
全	全
销	销
份	份
获	获
熟	熟
福	福
否	否
冠	冠
读	读
议	议
尼	尼
谱	谱
初	初
辑	辑
高	高
张	张
义	义
像	像
让	让
停	停
索	索
春	春
声	声
析	析
象	象
见	见
載	載
止	止
职	职
後	後
络	络
在	在
說	說
账	账
盈	盈
央	央
约	约
段	段
見	見
的	的
漫	漫
您	您
显	显
享	享
古	古
小	小
不	不
日	日
简	简
银	银
才	才
运	运
美	美
税	税
升	升
沙	沙
禁	禁
东	东
鱼	鱼
胆	胆
成	成
维	维
挂	挂
习	习
便	便
板	板
即	即
野	野
错	错
败	败
七	七
满	满
再	再
死	死
控	控
汽	汽
潮	潮
序	序
命	命
稿	稿
护	护
额	额
己	己
续	续
详	详
状	状
防	防
济	济
右	右
刷	刷
線	線
開	開
该	该
材	材
亚	亚
越	越
岁	岁
究	究
番	番
永	永
晚	晚
視	視
断	断
儿	儿
左	左
上	上
千	千
安	安
望	望
老	老
典	典
喜	喜
监	监
田	田
兴	兴
丁	丁
欢	欢
我	我
纪	纪
休	休
志	志
夫	夫
换	换
話	話
妹	妹
巴	巴
退	退
凰	凰
互	互
素	素
兑	兑
村	村
透	透
罗	罗
略	略
落	落
根	根
词	词
病	病
康	康
留	留
石	石
凰	凰
述	述
斗	斗
百	百
决	决
把	把
哥	哥
举	举
写	写
油	油
個	個
电	电
射	射
她	她
采	采
构	构
欧	欧
核	核
府	府
答	答
华	华
低	低
余	余
底	底
域	域
旅	旅
除	除
按	按
这	这
體	體
県	県
边	边
有	有
候	候
待	待
波	波
普	普
绍	绍
國	國
書	書
味	味
智	智
秒	秒
细	细
警	警
費	費
益	益
找	找
発	発
险	险
漏	漏
玩	玩
但	但
菲	菲
女	女
餐	餐
套	套
座	座
約	約
藏	藏
谁	谁
兰	兰
迎	迎
搜	搜
健	健
機	機
務	務
剧	剧
微	微
均	均
景	景
随	随
印	印
派	派
猜	猜
青	青
切	切
签	签
境	境
良	良
三	三
長	長
差	差
狗	狗
怎	怎
惠	惠
围	围
半	半
况	况
夏	夏
東	東
农	农
故	故
策	策
乳	乳
范	范
艇	艇
価	価
阿	阿
車	車
予	予
攻	攻
卓	卓
依	依
广	广
李	李
胜	胜
吉	吉
角	角
宾	宾
违	违
問	問
菜	菜
秘	秘
酒	酒
降	降
一	一
厅	厅
如	如
积	积
致	致
园	园
頻	頻
湖	湖
识	识
许	许
季	季
血	血
永	永
媒	媒
平	平
篮	篮
和	和
神	神
温	温
鲁	鲁
武	武
母	母
听	听
連	連
計	計
摸	摸
威	威
来	来
雷	雷
七	七
哈	哈
実	実
难	难
篇	篇
撸	撸
衣	衣
好	好
截	截
跑	跑
谢	谢
居	居
负	负
融	融
极	极
族	族
承	承
吃	吃
览	览
开	开
压	压
艺	艺
箱	箱
检	检
误	误
様	様
歌	歌
俺	俺
养	养
込	込
坚	坚
并	并
远	远
诉	诉
尚	尚
币	币
眼	眼
审	审
南	南
売	売
协	协
货	货
班	班
订	订
汇	汇
奶	奶
易	易
風	風
添	添
丝	丝
副	副
吉	吉
短	短
朝	朝
严	严
我	我
語	語
肉	肉
孩	孩
啊	啊
念	念
讲	讲
害	害
善	善
跟	跟
設	設
亲	亲
终	终
赔	赔
湾	湾
尊	尊
露	露
玄	玄
蛋	蛋
婆	婆
豪	豪
龙	龙
离	离
関	関
朋	朋
执	执
银	银
津	津
铁	铁
仅	仅
零	零
員	員
革	革
贴	贴
乡	乡
贵	贵
的	的
键	键
岛	岛
日	日
移	移
符	符
有	有
曲	曲
玉	玉
伯	伯
担	担
森	森
串	串
请	请
婚	婚
择	择
叫	叫
响	响
現	現
土	土
欲	欲
水	水
噜	噜
正	正
卫	卫
邮	邮
织	织
対	対
楽	楽
拿	拿
年	年
批	批
描	描
資	資
希	希
火	火
兵	兵
月	月
且	且
辆	辆
觉	觉
評	評
课	课
結	結
犯	犯
插	插
仙	仙
術	術
楼	楼
豹	豹
优	优
洞	洞
较	较
星	星
給	給
読	読
独	独
精	精
顺	顺
裸	裸
屋	屋
以	以
木	木
扫	扫
金	金
曰	曰
访	访
层	层
論	論
亮	亮
察	察
種	種
自	自
冷	冷
它	它
選	選
宣	宣
诺	诺
超	超
級	級
來	來
皇	皇
別	別
令	令
判	判
含	含
千	千
泰	泰
加	加
异	异
続	続
九	九
庄	庄
菲	菲
利	利
黄	黄
誉	誉
汉	汉
奥	奥
勤	勤
白	白
床	床
急	急
久	久
男	男
猫	猫
捕	捕
无	无
礼	礼
绝	绝
药	药
授	授
爱	爱
性	性
谷	谷
券	券
也	也
妈	妈
句	句
封	封
他	他
応	応
突	突
聞	聞
爆	爆
刘	刘
概	概
海	海
迅	迅
毒	毒
纳	纳
轻	轻
浪	浪
商	商
咨	咨
二	二
适	适
占	占
幅	幅
而	而
過	過
往	往
洋	洋
减	减
培	培
倫	倫
紧	紧
質	質
览	览
昌	昌
題	題
亿	亿
台	台
師	師
號	號
本	本
爰	爰
巨	巨
贝	贝
詳	詳
仕	仕
卖	卖
韩	韩
附	附
細	細
在	在
梦	梦
救	救
遗	遗
席	席
般	般
云	云
取	取
宝	宝
最	最
更	更
弊	弊
块	块
迪	迪
河	河
雄	雄
通	通
豆	豆
训	训
販	販
乌	乌
似	似
多	多
树	树
疗	疗
公	公
届	届
類	類
片	片
洗	洗
是	是
红	红
聚	聚
西	西
庭	庭
雨	雨
默	默
探	探
合	合
祝	祝
琪	琪
括	括
門	門
鼎	鼎
绑	绑
启	启
顶	顶
學	學
童	童
尽	尽
歳	歳
佳	佳
為	為
伟	伟
恐	恐
租	租
函	函
丽	丽
诗	诗
继	继
淫	淫
曾	曾
荣	荣
葡	葡
赞	赞
籍	籍
延	延
皮	皮
溪	溪
映	映
麻	麻
束	束
对	对
雪	雪
注	注
井	井
征	征
婦	婦
守	守
镇	镇
経	経
祥	祥
粉	粉
松	松
強	強
島	島
环	环
某	某
轮	轮
四	四
週	週
陈	陈
闭	闭
末	末
峰	峰
點	點
爵	爵
却	却
刻	刻
唐	唐
遇	遇
补	补
托	托
舞	舞
池	池
亂	亂
月	月
區	區
障	障
昨	昨
俄	俄
優	優
喷	喷
製	製
産	産
武	武
遮	遮
著	著
长	长
購	購
背	背
趣	趣
杯	杯
不	不
若	若
厂	厂
染	染
宇	宇
勒	勒
雅	雅
投	投
同	同
聘	聘
吸	吸
帝	帝
帮	帮
會	會
架	架
秀	秀
第	第
绿	绿
途	途
暂	暂
吹	吹
阿	阿
诀	诀
鸿	鸿
梅	梅
六	六
地	地
迷	迷
尾	尾
脱	脱
为	为
疑	疑
街	街
編	編
抓	抓
须	须
枚	枚
暴	暴
確	確
検	検
圣	圣
魔	魔
泉	泉
啦	啦
秋	秋
归	归
聚	聚
変	変
發	發
督	督
奸	奸
圳	圳
冲	冲
翻	翻
父	父
覧	覧
旺	旺
熱	熱
五	五
必	必
谈	谈
買	買
点	点
腹	腹
狂	狂
临	临
挡	挡
临	临
刚	刚
冻	冻
从	从
備	備
験	験
盛	盛
宅	宅
宿	宿
汇	汇
藝	藝
扣	扣
認	認
诚	诚
組	組
径	径
伤	伤
马	马
罪	罪
蛛	蛛
摄	摄
職	職
污	污
慰	慰
乎	乎
願	願
狗	狗
關	關
世	世
涉	涉
馆	馆
紹	紹
曜	曜
袜	袜
転	転
蛛	蛛
襪	襪
损	损
够	够
盒	盒
你	你
甘	甘
齐	齐
價	價
狐	狐
仁	仁
這	這
經	經
折	折
呢	呢
刺	刺
回	回
残	残
嘛	嘛
終	終
調	調
駅	駅
説	説
是	是
少	少
泽	泽
瑞	瑞
陵	陵
吨	吨
摘	摘
乐	乐
聊	聊
涨	涨
至	至
態	態
释	释
灵	灵
黑	黑
娘	娘
呼	呼
纸	纸
午	午
觀	觀
幻	幻
冰	冰
笔	笔
姓	姓
媽	媽
英	英
德	德
朗	朗
一	一
宜	宜
查	查
摩	摩
割	割
幸	幸
如	如
珠	珠
產	產
欧	欧
愿	愿
烈	烈
叶	叶
蓝	蓝
旧	旧
帝	帝
甲	甲
収	収
內	內
创	创
桃	桃
偷	偷
広	広
護	護
導	導
础	础
悠	悠
富	富
狼	狼
脸	脸
猛	猛
襪	襪
静	静
営	営
坐	坐
内	内
佛	佛
募	募
慢	慢
時	時
忘	忘
録	録
巴	巴
肥	肥
植	植
凯	凯
値	値
懂	懂
牲	牲
联	联
十	十
讨	讨
尺	尺
促	促
固	固
圈	圈
腿	腿
明	明
戲	戲
宗	宗
嫩	嫩
榜	榜
针	针
歩	歩
萬	萬
黃	黃
阁	阁
危	危
胸	胸
宁	宁
图	图
填	填
塔	塔
躁	躁
恩	恩
與	與
際	際
豪	豪
措	措
饰	饰
硬	硬
数	数
鬼	鬼
悉	悉
盾	盾
侵	侵
穿	穿
贸	贸
澳	澳
困	困
臣	臣
痛	痛
苦	苦
震	震
幼	幼
恒	恒
定	定
财	财
杂	杂
舰	舰
郎	郎
亡	亡
王	王
蓝	蓝
倒	倒
玛	玛
抗	抗
運	運
頁	頁
山	山
借	借
疫	疫
頭	頭
悦	悦
徒	徒
拖	拖
規	規
众	众
澡	澡
清	清
逼	逼
特	特
姑	姑
阴	阴
跨	跨
弄	弄
催	催
赤	赤
缩	缩
官	官
据	据
換	換
丹	丹
庫	庫
弹	弹
牛	牛
宫	宫
亞	亞
玖	玖
氣	氣
颜	颜
丰	丰
茶	茶
搞	搞
於	於
園	園
献	献
蒙	蒙
唯	唯
粗	粗
首	首
将	将
伴	伴
摇	摇
読	読
出	出
杨	杨
滚	滚
钢	钢
距	距
跳	跳
症	症
鸡	鸡
寸	寸
辅	辅
龄	龄
浦	浦
奈	奈
弟	弟
穴	穴
色	色
大	大
隐	隐
诊	诊
船	船
邦	邦
況	況
株	株
未	未
拉	拉
净	净
深	深
宜	宜
练	练
屏	屏
就	就
鑫	鑫
哪	哪
纯	纯
坑	坑
刊	刊
激	激
盖	盖
暖	暖
石	石
兼	兼
試	試
進	進
扑	扑
江	江
类	类
援	援
北	北
樂	樂
醒	醒
恒	恒
召	召
縮	縮
請	請
笑	笑
这	这
決	決
電	電
訊	訊
鑫	鑫
隆	隆
數	數
抽	抽
桥	桥
拟	拟
励	励
鲜	鲜
乌	乌
恋	恋
输	输
黎	黎
档	档
毫	毫
皆	皆
伙	伙
碼	碼
萨	萨
毕	毕
欢	欢
凡	凡
润	润
竟	竟
東	東
他	他
爸	爸
跌	跌
翼	翼
冬	冬
見	見
吴	吴
脚	脚
劳	劳
馬	馬
寄	寄
挑	挑
推	推
贫	贫
绩	绩
工	工
赵	赵
窗	窗
扬	扬
八	八
荷	荷
澳	澳
色	色
勇	勇
阪	阪
丈	丈
主	主
億	億
願	願
筑	筑
君	君
大	大
顾	顾
捷	捷
張	張
兽	兽
真	真
彼	彼
美	美
韓	韓
虽	虽
淘	淘
惊	惊
触	触
拥	拥
巨	巨
恶	恶
贷	贷
买	买
氏	氏
仍	仍
蜜	蜜
實	實
每	每
厚	厚
舒	舒
達	達
怕	怕
泰	泰
色	色
水	水
疆	疆
談	談
岗	岗
對	對
惑	惑
奇	奇
缺	缺
秒	秒
患	患
簡	簡
威	威
张	张
甚	甚
栏	栏
散	散
耐	耐
可	可
递	递
項	項
酸	酸
巡	巡
坡	坡
宽	宽
鼎	鼎
徐	徐
缘	缘
尤	尤
混	混
焦	焦
薦	薦
侣	侣
戦	戦
慧	慧
横	横
葉	葉
累	累
糖	糖
畫	畫
储	储
額	額
竹	竹
晨	晨
共	共
岸	岸
元	元
寻	寻
液	液
林	林
瓜	瓜
署	署
刑	刑
振	振
学	学
単	単
阶	阶
怀	怀
所	所
抢	抢
侠	侠
親	親
隔	隔
伯	伯
卓	卓
炸	炸
岡	岡
双	双
標	標
译	译
罚	罚
尚	尚
避	避
高	高
塞	塞
次	次
館	館
姨	姨
逆	逆
片	片
無	無
節	節
袋	袋
杰	杰
文	文
牙	牙
扩	扩
徽	徽
其	其
用	用
湿	湿
今	今
初	初
实	实
驾	驾
凯	凯
缓	缓
外	外
暗	暗
纬	纬
诺	诺
顿	顿
努	努
足	足
盐	盐
揭	揭
灯	灯
挥	挥
順	順
納	納
狠	狠
情	情
役	役
洁	洁
耀	耀
搭	搭
嫌	嫌
周	周
剑	剑
帖	帖
洛	洛
積	積
思	思
寿	寿
曼	曼
尿	尿
既	既
新	新
三	三
饮	饮
虚	虚
卷	卷
晓	晓
町	町
肯	肯
証	証
建	建
壁	壁
赏	赏
贡	贡
搏	搏
炎	炎
們	們
嘉	嘉
编	编
允	允
陰	陰
乘	乘
屁	屁
逸	逸
窝	窝
済	済
浴	浴
毎	毎
缴	缴
阳	阳
贵	贵
勝	勝
菜	菜
睡	睡
孕	孕
阵	阵
瓦	瓦
李	李
保	保
骨	骨
讀	讀
沙	沙
波	波
編	編
被	被
莱	莱
原	原
刀	刀
让	让
打	打
科	科
逐	逐
瓶	瓶
求	求
祖	祖
贯	贯
后	后
锦	锦
对	对
提	提
違	違
替	替
聯	聯
兴	兴
胡	胡
粤	粤
壇	壇
啥	啥
敬	敬
登	登
柜	柜
敢	敢
的	的
阅	阅
姆	姆
滑	滑
自	自
夹	夹
階	階
亏	亏
谁	谁
丁	丁
字	字
杏	杏
和	和
郑	郑
前	前
斤	斤
漂	漂
管	管
游	游
辉	辉
耳	耳
奋	奋
裁	裁
只	只
曝	曝
掉	掉
掲	掲
宋	宋
连	连
看	看
孙	孙
麦	麦
据	据
議	議
熊	熊
践	践
哦	哦
仪	仪
的	的
遍	遍
瑞	瑞
閱	閱
驰	驰
鹰	鹰
適	適
纷	纷
心	心
唱	唱
敏	敏
乃	乃
覆	覆
中	中
锁	锁
問	問
怪	怪
梁	梁
董	董
霞	霞
桶	桶
謝	謝
扶	扶
朱	朱
宮	宮
牢	牢
械	械
兒	兒
品	品
中	中
華	華
彻	彻
浩	浩
与	与
繁	繁
肃	肃
伟	伟
払	払
満	満
花	花
貨	貨
腐	腐
烟	烟
遊	遊
月	月
当	当
单	单
无	无
禧	禧
拼	拼
腾	腾
専	専
帐	帐
療	療
页	页
岭	岭
京	京
趋	趋
當	當
要	要
辽	辽
仓	仓
歲	歲
酷	酷
湖	湖
抱	抱
咪	咪
柴	柴
阿	阿
掌	掌
还	还
坊	坊
奴	奴
诈	诈
扎	扎
遭	遭
鼓	鼓
妞	妞
携	携
摩	摩
裤	裤
太	太
普	普
艾	艾
宏	宏
铁	铁
一	一
吊	吊
呵	呵
奔	奔
御	御
盈	盈
可	可
羊	羊
棒	棒
凌	凌
銀	銀
財	財
忍	忍
寒	寒
做	做
嗯	嗯
疾	疾
专	专
制	制
講	講
單	單
法	法
還	還
很	很
由	由
嘉	嘉
荡	荡
炮	炮
荣	荣
沟	沟
岳	岳
沒	沒
莉	莉
沁	沁
婷	婷
家	家
圆	圆
嗎	嗎
稱	稱
戴	戴
而	而
押	押
藤	藤
印	印
猪	猪
拜	拜
迹	迹
爷	爷
笑	笑
総	総
信	信
凤	凤
四	四
更	更
喝	喝
饭	饭
準	準
沉	沉
賞	賞
表	表
麟	麟
魂	魂
甸	甸
框	框
估	估
涩	涩
薪	薪
殊	殊
洪	洪
杭	杭
霍	霍
逃	逃
镜	镜
崎	崎
铺	铺
惠	惠
茗	茗
轩	轩
骑	骑
離	離
握	握
收	收
鹿	鹿
環	環
廉	廉
習	習
頂	頂
鐘	鐘
孔	孔
軽	軽
絡	絡
奥	奥
兄	兄
则	则
坦	坦
热	热
弱	弱
戒	戒
娜	娜
即	即
義	義
負	負
偏	偏
帯	帯
偶	偶
旬	旬
坏	坏
挣	挣
創	創
巻	巻
标	标
亦	亦
構	構
楚	楚
该	该
抵	抵
鸟	鸟
丘	丘
常	常
她	她
个	个
査	査
谓	谓
钮	钮
比	比
会	会
莫	莫
難	難
重	重
劇	劇
寨	寨
谋	谋
紫	紫
送	送
咋	咋
眉	眉
忠	忠
專	專
遂	遂
闲	闲
那	那
驻	驻
誘	誘
芝	芝
艷	艷
两	两
妖	妖
驶	驶
敌	敌
伝	伝
浆	浆
岩	岩
苑	苑
郭	郭
滨	滨
诸	诸
为	为
旋	旋
伸	伸
夺	夺
磨	磨
則	則
迟	迟
舗	舗
姿	姿
娇	娇
西	西
下	下
虑	虑
土	土
裝	裝
循	循
市	市
晒	晒
亭	亭
麟	麟
矿	矿
全	全
燃	燃
欣	欣
本	本
到	到
較	較
鞋	鞋
怒	怒
玉	玉
教	教
知	知
古	古
债	债
高	高
歓	歓
尊	尊
有	有
殖	殖
镇	镇
貸	貸
誰	誰
位	位
盗	盗
浮	浮
当	当
挺	挺
经	经
操	操
渡	渡
汉	汉
羞	羞
晴	晴
行	行
甘	甘
一	一
泊	泊
每	每
不	不
應	應
參	參
俗	俗
弃	弃
戸	戸
勿	勿
筹	筹
長	長
总	总
忧	忧
樣	樣
責	責
図	図
砖	砖
訂	訂
坪	坪
状	状
匹	匹
那	那
不	不
完	完
萝	萝
任	任
伊	伊
雞	雞
狸	狸
渠	渠
渐	渐
加	加
此	此
曹	曹
厨	厨
说	说
冒	冒
厕	厕
紫	紫
废	废
罗	罗
脂	脂
驱	驱
歴	歴
邮	邮
赶	赶
佐	佐
排	排
晶	晶
韓	韓
辛	辛
嘿	嘿
珍	珍
肌	肌
桌	桌
履	履
火	火
添	添
潜	潜
趣	趣
拓	拓
日	日
忙	忙
枪	枪
亩	亩
根	根
旦	旦
刘	刘
二	二
曾	曾
塑	塑
用	用
娃	娃
铭	铭
異	異
非	非
扒	扒
犬	犬
灾	灾
蒂	蒂
满	满
雀	雀
取	取
處	處
吾	吾
名	名
峡	峡
晋	晋
校	校
上	上
疯	疯
卒	卒
汗	汗
傳	傳
梦	梦
児	児
再	再
条	条
陌	陌
滤	滤
拾	拾
水	水
尖	尖
怡	怡
麻	麻
艳	艳
窥	窥
磁	磁
飯	飯
観	観
夕	夕
松	松
唐	唐
札	札
衡	衡
涯	涯
窍	窍
大	大
防	防
飲	飲
侧	侧
効	効
迈	迈
支	支
統	統
私	私
撮	撮
在	在
淫	淫
赢	赢
从	从
就	就
轨	轨
輪	輪
温	温
円	円
各	各
灣	灣
圣	圣
将	将
込	込
昌	昌
陽	陽
揉	揉
辰	辰
耗	耗
土	土
但	但
转	转
子	子
乾	乾
怖	怖
入	入
煌	煌
一	一
柱	柱
甜	甜
袖	袖
罩	罩
仲	仲
薄	薄
纽	纽
頃	頃
潭	潭
徴	徴
冊	冊
秦	秦
測	測
邻	邻
日	日
从	从
喊	喊
谜	谜
蔡	蔡
都	都
为	为
發	發
被	被
畅	畅
接	接
梯	梯
妙	妙
沿	沿
抜	抜
紅	紅
伍	伍
嘴	嘴
泡	泡
壮	壮
羽	羽
尋	尋
茸	茸
阻	阻
飞	飞
搜	搜
钱	钱
樓	樓
寺	寺
微	微
稍	稍
険	険
虐	虐
橋	橋
一	一
于	于
小	小
付	付
肺	肺
淡	淡
柔	柔
柏	柏
約	約
已	已
邑	邑
拔	拔
吻	吻
米	米
配	配
粒	粒
入	入
灵	灵
等	等
浜	浜
光	光
包	包
眠	眠
绕	绕
麗	麗
剩	剩
莲	莲
客	客
骚	骚
木	木
墨	墨
占	占
筋	筋
新	新
裙	裙
吴	吴
苗	苗
覽	覽
聲	聲
據	據
袭	袭
自	自
冈	冈
我	我
薬	薬
动	动
條	條
悲	悲
雑	雑
泛	泛
煤	煤
丹	丹
黒	黒
面	面
或	或
監	監
識	識
芸	芸
奷	奷
闪	闪
部	部
鄂	鄂
展	展
阜	阜
齢	齢
歡	歡
迫	迫
詞	詞
赖	赖
遵	遵
门	门
紙	紙
喜	喜
詢	詢
兔	兔
恢	恢
翠	翠
沃	沃
赤	赤
旨	旨
娛	娛
曲	曲
萄	萄
赠	赠
並	並
诱	诱
徳	徳
怀	怀
辞	辞
葡	葡
扰	扰
桂	桂
錄	錄
迁	迁
基	基
悪	悪
魔	魔
雅	雅
腾	腾
杜	杜
訳	訳
侯	侯
好	好
団	団
叉	叉
權	權
图	图
矩	矩
忽	忽
贝	贝
興	興
乔	乔
总	总
烧	烧
吟	吟
羽	羽
菌	菌
招	招
绥	绥
发	发
陶	陶
相	相
舍	舍
多	多
烦	烦
寫	寫
讓	讓
棋	棋
復	復
帳	帳
馈	馈
鸿	鸿
極	極
仔	仔
縄	縄
不	不
剂	剂
若	若
铜	铜
輸	輸
許	許
昭	昭
洪	洪
吕	吕
鉄	鉄
築	築
鉴	鉴
撤	撤
沈	沈
好	好
惨	惨
虫	虫
疲	疲
灰	灰
呈	呈
宴	宴
歷	歷
春	春
捕	捕
苍	苍
払	払
勢	勢
骤	骤
總	總
赋	赋
厘	厘
係	係
延	延
箭	箭
増	増
到	到
夢	夢
生	生
祝	祝
辦	辦
禽	禽
港	港
示	示
凤	凤
浓	浓
祭	祭
作	作
訪	訪
盐	盐
臀	臀
纵	纵
哈	哈
墙	墙
黃	黃
琴	琴
把	把
俊	俊
硕	硕
小	小
預	預
删	删
第	第
民	民
閉	閉
顔	顔
辽	辽
陷	陷
辣	辣
湘	湘
哭	哭
拒	拒
廣	廣
鹅	鹅
很	很
誌	誌
兩	兩
毁	毁
本	本
中	中
伏	伏
景	景
團	團
忆	忆
邪	邪
劲	劲
崇	崇
撃	撃
將	將
比	比
默	默
芳	芳
魅	魅
枝	枝
技	技
乙	乙
汤	汤
模	模
遥	遥
奏	奏
等	等
帅	帅
課	課
消	消
慎	慎
帽	帽
乗	乗
碑	碑
又	又
鸭	鸭
涙	涙
陪	陪
都	都
陈	陈
拼	拼
愛	愛
削	削
鼠	鼠
營	營
拳	拳
要	要
时	时
搬	搬
龍	龍
洛	洛
肤	肤
肩	肩
膽	膽
蜂	蜂
旺	旺
臺	臺
股	股
養	養
橾	橾
小	小
補	補
魏	魏
踪	踪
書	書
找	找
吐	吐
驗	驗
滴	滴
私	私
等	等
猴	猴
熟	熟
処	処
動	動
电	电
虹	虹
摆	摆
当	当
美	美
埃	埃
苏	苏
同	同
凉	凉
月	月
郵	郵
偿	偿
功	功
空	空
泳	泳
纠	纠
秋	秋
響	響
顺	顺
證	證
從	從
芽	芽
钻	钻
馨	馨
逊	逊
悟	悟
遠	遠
坝	坝
焼	焼
韦	韦
隆	隆
塘	塘
简	简
尸	尸
診	診
相	相
滋	滋
麼	麼
的	的
働	働
腰	腰
俱	俱
弗	弗
修	修
扱	扱
叔	叔
覽	覽
盆	盆
草	草
社	社
拘	拘
敗	敗
思	思
択	択
属	属
踏	踏
減	減
炒	炒
圾	圾
跃	跃
莎	莎
赫	赫
鹏	鹏
有	有
梨	梨
玲	玲
贤	贤
强	强
第	第
电	电
达	达
沖	沖
戶	戶
使	使
輯	輯
指	指
舔	舔
系	系
兆	兆
人	人
半	半
協	協
它	它
碎	碎
蛇	蛇
純	純
攝	攝
轉	轉
惜	惜
即	即
荒	荒
左	左
据	据
牧	牧
物	物
仅	仅
宣	宣
佩	佩
逻	逻
呼	呼
豊	豊
帰	帰
弘	弘
格	格
双	双
凝	凝
日	日
胞	胞
引	引
媳	媳
契	契
葛	葛
呀	呀
遣	遣
變	變
垃	垃
筆	筆
岳	岳
凸	凸
级	级
緒	緒
意	意
锐	锐
两	两
紀	紀
奉	奉
柏	柏
遂	遂
坂	坂
厉	厉
件	件
泄	泄
方	方
固	固
開	開
项	项
財	財
涛	涛
盤	盤
飛	飛
经	经
应	应
靖	靖
幽	幽
沢	沢
和	和
柄	柄
暮	暮
三	三
維	維
強	強
胶	胶
丸	丸
生	生
萌	萌
夏	夏
克	克
仲	仲
佣	佣
察	察
撒	撒
铜	铜
悠	悠
灭	灭
济	济
討	討
丶	丶
鸣	鸣
戀	戀
賀	賀
絲	絲
金	金
須	須
更	更
下	下
道	道
哲	哲
擦	擦
羅	羅
风	风
拆	拆
公	公
赌	赌
喘	喘
野	野
拨	拨
能	能
权	权
颗	颗
凭	凭
厦	厦
軍	軍
聪	聪
砂	砂
看	看
翠	翠
省	省
撞	撞
囲	囲
本	本
两	两
暇	暇
据	据
瞬	瞬
姜	姜
妮	妮
採	採
绪	绪
昆	昆
椒	椒
贺	贺
牡	牡
柳	柳
擊	擊
戻	戻
杨	杨
言	言
控	控
欠	欠
剤	剤
領	領
杏	杏
毅	毅
又	又
铃	铃
炼	炼
糕	糕
兰	兰
插	插
咖	咖
腳	腳
绘	绘
魚	魚
燕	燕
放	放
色	色
莞	莞
曰	曰
朝	朝
此	此
暑	暑
國	國
卸	卸
西	西
披	披
食	食
惯	惯
掃	掃
靖	靖
煙	煙
五	五
城	城
寓	寓
判	判
多	多
毛	毛
杆	杆
倾	倾
嫁	嫁
密	密
嘎	嘎
写	写
辱	辱
掛	掛
栗	栗
腕	腕
战	战
欺	欺
日	日
与	与
棚	棚
潔	潔
轴	轴
隊	隊
読	読
堡	堡
翔	翔
涵	涵
胎	胎
孤	孤
猎	猎
泛	泛
汁	汁
调	调
举	举
人	人
二	二
得	得
粮	粮
滿	滿
禾	禾
宠	宠
筛	筛
感	感
衡	衡
骰	骰
鲸	鲸
柳	柳
钥	钥
淘	淘
描	描
集	集
去	去
璃	璃
舟	舟
尝	尝
身	身
戰	戰
共	共
匙	匙
寝	寝
瓣	瓣
辺	辺
晰	晰
当	当
敵	敵
纲	纲
玻	玻
屯	屯
漢	漢
疼	疼
泥	泥
點	點
抚	抚
赁	赁
発	発
蝶	蝶
栋	栋
孟	孟
胖	胖
月	月
称	称
墓	墓
嬉	嬉
康	康
辖	辖
纳	纳
埔	埔
颖	颖
寶	寶
琳	琳
撑	撑
杉	杉
引	引
丨	丨
剪	剪
申	申
邦	邦
鍵	鍵
起	起
車	車
競	競
慈	慈
嫂	嫂
個	個
頼	頼
癌	癌
淮	淮
膜	膜
芬	芬
呻	呻
昂	昂
房	房
届	届
錯	錯
鼻	鼻
解	解
纬	纬
醫	醫
高	高
雕	雕
堵	堵
彦	彦
铭	铭
傷	傷
莱	莱
裂	裂
芯	芯
却	却
絶	絶
运	运
臭	臭
翁	翁
夜	夜
饰	饰
同	同
鹤	鹤
彰	彰
閲	閲
苍	苍
晋	晋
他	他
禁	禁
锡	锡
績	績
吞	吞
睛	睛
浅	浅
殺	殺
壹	壹
姚	姚
于	于
防	防
酒	酒
鳥	鳥
穆	穆
医	医
赴	赴
詳	詳
请	请
昔	昔
貌	貌
摄	摄
愛	愛
約	約
締	締
桑	桑
莓	莓
歉	歉
僕	僕
楽	楽
旭	旭
如	如
应	应
鏈	鏈
獸	獸
导	导
翌	翌
化	化
谨	谨
敦	敦
桃	桃
水	水
琪	琪
雷	雷
辨	辨
卡	卡
踩	踩
蕩	蕩
覚	覚
徒	徒
玛	玛
貼	貼
網	網
锅	锅
爵	爵
気	気
雙	雙
帶	帶
美	美
農	農
胃	胃
裕	裕
涓	涓
沪	沪
碍	碍
暨	暨
蒲	蒲
側	側
弘	弘
留	留
妓	妓
醉	醉
槽	槽
衛	衛
给	给
評	評
倡	倡
裏	裏
纹	纹
霍	霍
希	希
理	理
卢	卢
炉	炉
第	第
湘	湘
潘	潘
橹	橹
卧	卧
氧	氧
日	日
店	店
張	張
副	副
熊	熊
横	横
傅	傅
市	市
型	型
会	会
續	續
扎	扎
本	本
三	三
廷	廷
桂	桂
佛	佛
昼	昼
徐	徐
活	活
旁	旁
彭	彭
